30 100
ATGAAATAAGGAAGGTATGGTTAAGAGTCA|GCCGGGGTTAAAGCAGACTGGGCGGTGAAC
TCGCGAATCTGTATTCATTAAAGGACCTTG|GTAAAGGTCATTGTGTACCACTGGTGCTCC
CGGTGGGGGGACTCGGAATGTGATACAAAT|CTGATAGTCAGCGATTCTGTACTCGTGCAC
GCTCTGTAAAGGTCATTGTGTACCACTGGT|ACCCGACCGCCTTAGACTCCTGTCTAATAC
GTGCTCCGCGCCCGACCCCGGCCTTCTCTG|ACTGGTCCCACTGTGTAAATACCCTTTGTC
CCAGTATGCCCCGCGAGGGCTGATTTCATA|ATGCATAGGACCTTGCGCAAATAACGGGAG
CTCAACTGCAAATTAGTAAGCCAATGCTCC|GTCCAACGAGGACCTTGCGCAAATAACGGG
TCCTATGAAATAAGGAAGGTATGGTTAAGA|GCAAGCCGGGGTTAAAGCAGACTGGGCGGT
ACGGGGCCTACGGTGAGCCGGCGTATGCAT|ACCAGGTGGATAGAAGATCCTGTTCTAAAA
CCCCCCAGTTTGGAATGGAACCAAATCCAC|AAGAGTCACATCACCTAAAAATCTCGAGAG
AAATAACGGGGCCTACGGTGGGGGGACTCG|CACCTCCATTTTCCACTGATAGTCAGCGAT
GCATCAAGGACCTTGCGCAAATAACGGGGC|AATAACGGGGCCTACGGAGCTGTATCGAGG
CTACGGAGCTGTATCGAGGACCTTGCGCAA|CGGGGCCTACGGCCCCGAGGACCTTGCGCA
AAAGGCACGGTGTCCTATGAAATAAGGAAG|CTTGGATCCTATGCAAGCCGGGGTTAAAGC
CCTTGCGCAAATAACGGGGCCTACGGGGCC|TTGCGCAAATAACGGGGCCTACGGTGGGGG
TTGCGCAAATAACGGAGGACCTTGCGCAAA|GATATGTAGCCGGAGGACCTTGCGCAAATA
CAAATAACGGGGCCTACGGAGCTGTATCGA|CTTGCGCAAATAACGGGGCCTACGGCCCCG
ACGGGAGGACCTTGCGCAAATAACGGGGCC|GGACCTTGCGCAAATAACGGGGCCTACGGG
CCTACGGCTCGATATGTAGCCGGAGGACCT|CCTTCTCTGTTGCGGCATTGTCTATGTTCT
TATGGTTAAGAGTCACATCACCTAAAAATC|GACTGGGCGGTGAACGCGCGCCAAACTTCA
AACGGGGCCTACGGCACCCGTCTAACTGAG|GGTGCGCGAATGGGCTCGCGAATCTGTATT
CGGAGGACCTTGCGCAAATAACGGGGCCTA|GAGGACCTTGCGCAAATAACGGGGCCTACG
CAGACATTGCACTGTTTTATTATTTTTCGT|TTCTAATATGTTGTGTTCCCGACAGTTGGC
ATAACGGGGCCTACGGGGCCTACGGTAGTC|AACGGGGCCTACGGTGGGGGGACTCGGAAT
GTATCGAGGACCTTGCGCAAATAACGGGGC|GGCCCCGAGGACCTTGCGCAAATAACGGAG
CCAGTTACGTCCAACGAGGACCTTGCGCAA|CTGTTCCATGGCATGCCTACCTGTTAGCTG
TGCGCAAATAACGGGGCCTACGGCACCCGT|GGTAGTCGGGGTGCGCGAATGGGCTCGCGA
TTCGTTCTTACGGCTGAGCCCTGTCCTCAA|TTGGCAGAACACTATGACCAGTTACGTCCA
CCCGTCTAACTGAGGACCTTGCGCAAATAA|CGCGAATCTGTATTCATTAAAGGACCTTGC
TATGCCCCGCGAGGGCTGATTTCATAATTC|ATAGGACCTTGCGCAAATAACGGGAGGACC
GCAAATAACGGGGCCTACGGTGAGCCGGCG|GCTGTGAACCAGGTGGATAGAAGATCCTGT
GCCTATACGCATCAAGGACCTTGCGCAAAT|CTTGCGCAAATAACGGGGCCTACGGAGCTG
CGCATCAAGGACCTTGCGCAAATAACGGGG|AAATAACGGGGCCTACGGAGCTGTATCGAG
AGACTGGGCGGTGAACGCGCGCCAAACTTC|TTGCGCAAATAACGGGGCCTACGGCACCCG
GAGCCGGCGTATGCATAGGACCTTGCGCAA|AGATCCTGTTCTAAAAGCATCTTGTATACC
TGTAAATACCCTTTGTCGCATGCCCGAATT|AGACCATAAAAGGCAAGGGCCTGTGGGTGC
ATGGAACCAAATCCACGAAGGACCTTGCGC|CTAAAAATCTCGAGAGCCTATACGCATCAA
CAAATAACGGGAGGACCTTGCGCAAATAAC|ACCATAGGACCTTGCGCAAATAACGGGGCC
CAAATAACGGGGCCTACGGCTCGATATGTA|GCCCGACCCCGGCCTTCTCTGTTGCGGCAT
GCATGCCTACCTGTTAGCTGTGAACCAGGT|TCCACGAAGGACCTTGCGCAAATAACGGGG
TAACGGGGCCTACGGGGCCTACGGTAGTCG|ACGGGGCCTACGGTGGGGGGACTCGGAATG
GGCCTACGGTGAGCCGGCGTATGCATAGGA|GGTGGATAGAAGATCCTGTTCTAAAAGCAT
AGTCAGCGATTCTGTACTCGTGCACGACCC|CTTTCAGCCCTCCATCGAACGACACGTTTG
TCTAATACTGGTCCCACTGTGTAAATACCC|GTTATGCGCATTTCACTGAAGACCATAAAA
GGGAGGACCTTGCGCAAATAACGGGGCCTA|ACCTTGCGCAAATAACGGGGCCTACGGGTC
ATCCACGAAGGACCTTGCGCAAATAACGGG|CGAGAGCCTATACGCATCAAGGACCTTGCG
TACGGGTGGGTACTGTTCCATGGCATGCCT|CCCAGTTTGGAATGGAACCAAATCCACGAA
AAGCCGGGGTTAAAGCAGACTGGGCGGTGA|CGAAGGTGTGAGGACCTTGCGCAAATAACG
TCAGAGGACCTTGCGCAAATAACGGGGCCT|CGTCTAACTGAGGACCTTGCGCAAATAACG
GGCCTACGGTGGGGGGACTCGGAATGTGAT|TTTCCACTGATAGTCAGCGATTCTGTACTC
TTGCGCAAATAACGGGGCCTACGGTGAGCC|GTTAGCTGTGAACCAGGTGGATAGAAGATC
ATCTGTATTCATTAAAGGACCTTGCGCAAA|GTCATTGTGTACCACTGGTGCTCCGCGCCC
CCCTTTGTCGCATGCCCGAATTTTAAGCAG|AAAGGCAAGGGCCTGTGGGTGCGTAATATT
CGCAAATAACGGGGCCTACGGTGGGGGGAC|GTCCACCTCCATTTTCCACTGATAGTCAGC
CTTGCGCAAATAACGGGGCCTACGGGTTCA|CTACGGAGCTGTATCGAGGACCTTGCGCAA
CCTACGGGGCCTACGGTAGTCGGGGTGCGC|TACGGTGGGGGGACTCGGAATGTGATACAA
CGGGAGGACCTTGCGCAAATAACGGGGCCT|GACCTTGCGCAAATAACGGGGCCTACGGGT
ACGGGGCCTACGGATGGCGTCGAGCCGAAG|AACGGAGGACCTTGCGCAAATAACGGGGCC
GGCCTACGGAGCTGTATCGAGGACCTTGCG|TAACGGGGCCTACGGCCCCGAGGACCTTGC
AACGAGGACCTTGCGCAAATAACGGGGCCT|ATGCCTACCTGTTAGCTGTGAACCAGGTGG
TAAAAATCTCGAGAGCCTATACGCATCAAG|AAACTTCAGAGGACCTTGCGCAAATAACGG
TTTCATAATTCTAATATGTTGTGTTCCCGA|ACGGGAGGACCTTGCGCAAATAACGGGGCC
ACTGAGGACCTTGCGCAAATAACGGGGCCT|TGTATTCATTAAAGGACCTTGCGCAAATAA
CCTCCATTTTCCACTGATAGTCAGCGATTC|CACGTTTGAAACGGCCTACTTTCAGCCCTC
CTACGGCACCCGTCTAACTGAGGACCTTGC|AATGGGCTCGCGAATCTGTATTCATTAAAG
CCTGTTCTAAAAGCATCTTGTATACCATAG|CGCAAATAACGGGGCCTACGGTACGGAAAG
GCACGACCCGACCGCCTTAGACTCCTGTCT|ACACGTTTGCGACTGCTTGATACTCGAGTT
AGGACCTTGCGCAAATAACGGGGCCTACGG|GGCCTACGGTAGTCGGGGTGCGCGAATGGG
AGCTGTGAACCAGGTGGATAGAAGATCCTG|GCGCAAATAACGGGGCCAGGACCTTGCGCA
AATGCTCCGCGCGTCCACGTATCACCCCCA|ATAACGGGGCCTACGGTGAGCCGGCGTATG
GGTGAACGCGCGCCAAACTTCAGAGGACCT|TAACGGGGCCTACGGCACCCGTCTAACTGA
TAAGAGTCACATCACCTAAAAATCTCGAGA|GCGGTGAACGCGCGCCAAACTTCAGAGGAC
GGACCTTGCGCAAATAACGGGGCCTACGGC|GCCTACGGTAGTCGGGGTGCGCGAATGGGC
CCTATACGCATCAAGGACCTTGCGCAAATA|TTGCGCAAATAACGGGGCCTACGGAGCTGT
TGTTCTCGGTCCACCTCCATTTTCCACTGA|AAGCAGCGACCACCACGTTTGAAACGGCCT
GGACCTTGCGCAAATAACGGGGCCTACGGT|TGTTCTCGGTCCACCTCCATTTTCCACTGA
CCTACGGTGAGCCGGCGTATGCATAGGACC|TGGATAGAAGATCCTGTTCTAAAAGCATCT
AGAAGATCCTGTTCTAAAAGCATCTTGTAT|GACCTTGCGCAAATAACGGGGCCTACGGTA
CTCGGTCCACCTCCATTTTCCACTGATAGT|AGCGACCACCACGTTTGAAACGGCCTACTT
GCAAATAACGGGGCCAGGACCTTGCGCAAA|AAGGACCTTGCGCAAATAACGGGGCCTACG
TGGTCCCACTGTGTAAATACCCTTTGTCGC|CATTTCACTGAAGACCATAAAAGGCAAGGG
GTTCTTACGGCTGAGCCCTGTCCTCAACTG|GCAGAACACTATGACCAGTTACGTCCAACG
ATTCTACACAAGCTTGGATCCTATGCAAGC|AACGGGGCCTACGGATGGCGTCGAGCCGAA
TGTCCTCAACTGCAAATTAGTAAGCCAATG|TTACGTCCAACGAGGACCTTGCGCAAATAA
TAACGGGGCCTACGGATGGCGTCGAGCCGA|ATAACGGAGGACCTTGCGCAAATAACGGGG
CTGATTTCATAATTCTAATATGTTGTGTTC|AATAACGGGAGGACCTTGCGCAAATAACGG
GGCCTACGGTACGGAAAGGCACGGTGTCCT|GTATTCTACACAAGCTTGGATCCTATGCAA
TCAGACATTGCACTGTTTTATTATTTTTCG|ATTCTAATATGTTGTGTTCCCGACAGTTGG
GTAACGCACGTCAGACATTGCACTGTTTTA|TGATTTCATAATTCTAATATGTTGTGTTCC
GGGTCTGTCCCCCCAGTTTGGAATGGAACC|GTATGGTTAAGAGTCACATCACCTAAAAAT
GGACCTTGCGCAAATAACGGGGCCTACGGT|TACCTGTTAGCTGTGAACCAGGTGGATAGA
TGCTCCGCGCGTCCACGTATCACCCCCAGT|AACGGGGCCTACGGTGAGCCGGCGTATGCA
CCGCCTTAGACTCCTGTCTAATACTGGTCC|ACTGCTTGATACTCGAGTTATGCGCATTTC
GGCGGTGAACGCGCGCCAAACTTCAGAGGA|AAATAACGGGGCCTACGGCACCCGTCTAAC
TGTCTATGTTCTCGGTCCACCTCCATTTTC|AATTTTAAGCAGCGACCACCACGTTTGAAA
GGACTCGGAATGTGATACAAATAGCTCTGT|CAGCGATTCTGTACTCGTGCACGACCCGAC
TGAGCCCTGTCCTCAACTGCAAATTAGTAA|TGACCAGTTACGTCCAACGAGGACCTTGCG
GCCTACGGTACGGAAAGGCACGGTGTCCTA|TATTCTACACAAGCTTGGATCCTATGCAAG
CCGAGGACCTTGCGCAAATAACGGAGGACC|CTACGGCTCGATATGTAGCCGGAGGACCTT
AACCAAATCCACGAAGGACCTTGCGCAAAT|AAATCTCGAGAGCCTATACGCATCAAGGAC
AATAACGGGGCCTACGGGCCTACGGGTGGG|GGGGCCTACGGGTCTGTCCCCCCAGTTTGG
CTACGGGCCTACGGGTGGGTACTGTTCCAT|GTCTGTCCCCCCAGTTTGGAATGGAACCAA
GGGCCTACGGTAGTCGGGGTGCGCGAATGG|GGGGGGACTCGGAATGTGATACAAATAGCT
CTACGGTACGGAAAGGCACGGTGTCCTATG|TTCTACACAAGCTTGGATCCTATGCAAGCC
TGAGGACCTTGCGCAAATAACGGGGCCTAC|GGGGCCTACGGTAGTCGGGGTGCGCGAATG
TTGGATCCTATGCAAGCCGGGGTTAAAGCA|GATGGCGTCGAGCCGAAGGTGTGAGGACCT
CAAATAACGGGGCCTACGGGTCTGTCCCCC|CCTATGAAATAAGGAAGGTATGGTTAAGAG
GGGCCTACGGCTCGATATGTAGCCGGAGGA|CGGCCTTCTCTGTTGCGGCATTGTCTATGT
TGTGAGGACCTTGCGCAAATAACGGGGCCT|ACGGGGCCTACGGTAGTCGGGGTGCGCGAA
GCTCGATATGTAGCCGGAGGACCTTGCGCA|CTGTTGCGGCATTGTCTATGTTCTCGGTCC
ATGGGCTCGCGAATCTGTATTCATTAAAGG|AGCTCTGTAAAGGTCATTGTGTACCACTGG
GTTCCATGGCATGCCTACCTGTTAGCTGTG|GAACCAAATCCACGAAGGACCTTGCGCAAA
CACTGATAGTCAGCGATTCTGTACTCGTGC|CGGCCTACTTTCAGCCCTCCATCGAACGAC
TTGCGCAAATAACGGGGCCTACGGGGCCTA|GCGCAAATAACGGGGCCTACGGTGGGGGGA
CGTCCAACGAGGACCTTGCGCAAATAACGG|ATGGCATGCCTACCTGTTAGCTGTGAACCA
TCTGTAAAGGTCATTGTGTACCACTGGTGC|CCGACCGCCTTAGACTCCTGTCTAATACTG
GAATGGGCTCGCGAATCTGTATTCATTAAA|ATAGCTCTGTAAAGGTCATTGTGTACCACT
GCCGGGGTTAAAGCAGACTGGGCGGTGAAC|AAGGTGTGAGGACCTTGCGCAAATAACGGG
ATACCATAGGACCTTGCGCAAATAACGGGG|TACGGAAAGGCACGGTGTCCTATGAAATAA
CCTTGCGCAAATAACGGGGCCTACGGCTCG|GCTCCGCGCCCGACCCCGGCCTTCTCTGTT
GTAAGCCAATGCTCCGCGCGTCCACGTATC|TGCGCAAATAACGGGGCCTACGGTGAGCCG
AACGCGCGCCAAACTTCAGAGGACCTTGCG|GGGGCCTACGGCACCCGTCTAACTGAGGAC
TACGGGCCTACGGGTGGGTACTGTTCCATG|TCTGTCCCCCCAGTTTGGAATGGAACCAAA
GATTCTGTACTCGTGCACGACCCGACCGCC|CCCTCCATCGAACGACACGTTTGCGACTGC
CTTGCGCAAATAACGGGGCCTACGGGCCTA|CAAATAACGGGGCCTACGGGTCTGTCCCCC
CATTGCACTGTTTTATTATTTTTCGTTCTT|AATATGTTGTGTTCCCGACAGTTGGCAGAA
CGCGAGGGCTGATTTCATAATTCTAATATG|CTTGCGCAAATAACGGGAGGACCTTGCGCA
AAGCATCTTGTATACCATAGGACCTTGCGC|GGGGCCTACGGTACGGAAAGGCACGGTGTC
CTACGGTAGTCGGGGTGCGCGAATGGGCTC|GGACTCGGAATGTGATACAAATAGCTCTGT
TTTGTCGCATGCCCGAATTTTAAGCAGCGA|GGCAAGGGCCTGTGGGTGCGTAATATTCGC
AGGACCTTGCGCAAATAACGGGGCCAGGAC|TATACGCATCAAGGACCTTGCGCAAATAAC
CTACGGGTTCAGTATTCTACACAAGCTTGG|ACCTTGCGCAAATAACGGGGCCTACGGATG
ACGGGGCCTACGGGGCCTACGGTAGTCGGG|GGGGCCTACGGTGGGGGGACTCGGAATGTG
ACGGTACGGAAAGGCACGGTGTCCTATGAA|CTACACAAGCTTGGATCCTATGCAAGCCGG
AAAGGTCATTGTGTACCACTGGTGCTCCGC|CGCCTTAGACTCCTGTCTAATACTGGTCCC
CCCGGCCTTCTCTGTTGCGGCATTGTCTAT|AAATACCCTTTGTCGCATGCCCGAATTTTA
GAAAGGCACGGTGTCCTATGAAATAAGGAA|GCTTGGATCCTATGCAAGCCGGGGTTAAAG
CACAAGCTTGGATCCTATGCAAGCCGGGGT|GCCTACGGATGGCGTCGAGCCGAAGGTGTG
CAGACTGGGCGGTGAACGCGCGCCAAACTT|CTTGCGCAAATAACGGGGCCTACGGCACCC
AGGGCTGATTTCATAATTCTAATATGTTGT|CGCAAATAACGGGAGGACCTTGCGCAAATA
AACGGGGCCTACGGCCCCGAGGACCTTGCG|GCGCAAATAACGGGGCCTACGGCTCGATAT
TGGATCCTATGCAAGCCGGGGTTAAAGCAG|ATGGCGTCGAGCCGAAGGTGTGAGGACCTT
AGTAAGCCAATGCTCCGCGCGTCCACGTAT|TTGCGCAAATAACGGGGCCTACGGTGAGCC
CGGCTGAGCCCTGTCCTCAACTGCAAATTA|ACTATGACCAGTTACGTCCAACGAGGACCT
CGCAAATAACGGGGCCTACGGCCCCGAGGA|GGACCTTGCGCAAATAACGGGGCCTACGGC
ACCTTGCGCAAATAACGGGGCCTACGGAGC|CTGAGGACCTTGCGCAAATAACGGGGCCTA
ACCACTGGTGCTCCGCGCCCGACCCCGGCC|GTCTAATACTGGTCCCACTGTGTAAATACC
AATACCCTTTGTCGCATGCCCGAATTTTAA|CATAAAAGGCAAGGGCCTGTGGGTGCGTAA
AGGACCTTGCGCAAATAACGGGGCCTACGG|GAGGACCTTGCGCAAATAACGGAGGACCTT
GGCCTACGGGTGGGTACTGTTCCATGGCAT|TCCCCCCAGTTTGGAATGGAACCAAATCCA
GCGCCCGACCCCGGCCTTCTCTGTTGCGGC|CCACTGTGTAAATACCCTTTGTCGCATGCC
AGCTCTGTAAAGGTCATTGTGTACCACTGG|GACCCGACCGCCTTAGACTCCTGTCTAATA
GGTTAAAGCAGACTGGGCGGTGAACGCGCG|GTGAGGACCTTGCGCAAATAACGGGGCCTA
GCGCGCCAAACTTCAGAGGACCTTGCGCAA|GCCTACGGCACCCGTCTAACTGAGGACCTT
GGGGCCAGGACCTTGCGCAAATAACGGGGC|GCGCAAATAACGGGGCCTACGGGTTCAGTA
CGGCCTTCTCTGTTGCGGCATTGTCTATGT|ATACCCTTTGTCGCATGCCCGAATTTTAAG
CCCCAGTTTGGAATGGAACCAAATCCACGA|GAGTCACATCACCTAAAAATCTCGAGAGCC
AACGGGGCCTACGGGCCTACGGGTGGGTAC|GCCTACGGGTCTGTCCCCCCAGTTTGGAAT
GGCACGGTGTCCTATGAAATAAGGAAGGTA|GGATCCTATGCAAGCCGGGGTTAAAGCAGA
CATCAAGGACCTTGCGCAAATAACGGGGCC|ATAACGGGGCCTACGGAGCTGTATCGAGGA
TCGGAATGTGATACAAATAGCTCTGTAAAG|GATTCTGTACTCGTGCACGACCCGACCGCC
CCACTGATAGTCAGCGATTCTGTACTCGTG|ACGGCCTACTTTCAGCCCTCCATCGAACGA
CCACTGTGTAAATACCCTTTGTCGCATGCC|CACTGAAGACCATAAAAGGCAAGGGCCTGT
GGTGCTCCGCGCCCGACCCCGGCCTTCTCT|TACTGGTCCCACTGTGTAAATACCCTTTGT
TTTCGTTCTTACGGCTGAGCCCTGTCCTCA|GTTGGCAGAACACTATGACCAGTTACGTCC
TCCCGACAGTTGGCAGAACACTATGACCAG|GGGGCCTACGGGCCTACGGGTGGGTACTGT
GCGCGTCCACGTATCACCCCCAGTATGCCC|GCCTACGGTGAGCCGGCGTATGCATAGGAC
CTTGGATCCTATGCAAGCCGGGGTTAAAGC|GGATGGCGTCGAGCCGAAGGTGTGAGGACC
TATGCAAGCCGGGGTTAAAGCAGACTGGGC|CGAGCCGAAGGTGTGAGGACCTTGCGCAAA
ACGAGGACCTTGCGCAAATAACGGGGCCTA|TGCCTACCTGTTAGCTGTGAACCAGGTGGA
CACCCCCAGTATGCCCCGCGAGGGCTGATT|GGCGTATGCATAGGACCTTGCGCAAATAAC
TAGTCGGGGTGCGCGAATGGGCTCGCGAAT|GGAATGTGATACAAATAGCTCTGTAAAGGT
ATGTAGCCGGAGGACCTTGCGCAAATAACG|GGCATTGTCTATGTTCTCGGTCCACCTCCA
TAACGGGGCCTACGGCCCCGAGGACCTTGC|TGCGCAAATAACGGGGCCTACGGCTCGATA
TCTTGTATACCATAGGACCTTGCGCAAATA|CTACGGTACGGAAAGGCACGGTGTCCTATG
GAGGACCTTGCGCAAATAACGGGGCCTACG|CCTACCTGTTAGCTGTGAACCAGGTGGATA
GCTTGGATCCTATGCAAGCCGGGGTTAAAG|CGGATGGCGTCGAGCCGAAGGTGTGAGGAC
CTGTTTTATTATTTTTCGTTCTTACGGCTG|TGTGTTCCCGACAGTTGGCAGAACACTATG
AATCTGTATTCATTAAAGGACCTTGCGCAA|GGTCATTGTGTACCACTGGTGCTCCGCGCC
CAAACTTCAGAGGACCTTGCGCAAATAACG|GGCACCCGTCTAACTGAGGACCTTGCGCAA
CGGGTCTGTCCCCCCAGTTTGGAATGGAAC|GGTATGGTTAAGAGTCACATCACCTAAAAA
CGACCCGACCGCCTTAGACTCCTGTCTAAT|CGTTTGCGACTGCTTGATACTCGAGTTATG
CGCAAATAACGGGGCCTACGGTACGGAAAG|CCTACGGGTTCAGTATTCTACACAAGCTTG
ACGGGGCCTACGGTACGGAAAGGCACGGTG|TTCAGTATTCTACACAAGCTTGGATCCTAT
AAGAGTCACATCACCTAAAAATCTCGAGAG|CGGTGAACGCGCGCCAAACTTCAGAGGACC
CCATTTTCCACTGATAGTCAGCGATTCTGT|GTTTGAAACGGCCTACTTTCAGCCCTCCAT
AATAACGGGGCCTACGGTACGGAAAGGCAC|CGGGTTCAGTATTCTACACAAGCTTGGATC
CGGTACGGAAAGGCACGGTGTCCTATGAAA|TACACAAGCTTGGATCCTATGCAAGCCGGG
TTCAGTATTCTACACAAGCTTGGATCCTAT|GCAAATAACGGGGCCTACGGATGGCGTCGA
AACACTATGACCAGTTACGTCCAACGAGGA|CGGGTGGGTACTGTTCCATGGCATGCCTAC
AACGGGAGGACCTTGCGCAAATAACGGGGC|AGGACCTTGCGCAAATAACGGGGCCTACGG
GATCCTATGCAAGCCGGGGTTAAAGCAGAC|GGCGTCGAGCCGAAGGTGTGAGGACCTTGC
CTACGGGGCCTACGGTAGTCGGGGTGCGCG|ACGGTGGGGGGACTCGGAATGTGATACAAA
GCGCAAATAACGGAGGACCTTGCGCAAATA|TATGTAGCCGGAGGACCTTGCGCAAATAAC
CTGATAGTCAGCGATTCTGTACTCGTGCAC|GCCTACTTTCAGCCCTCCATCGAACGACAC
CCCGAATTTTAAGCAGCGACCACCACGTTT|GTGGGTGCGTAATATTCGCAAAGCATACTC
TACGGGTTCAGTATTCTACACAAGCTTGGA|CCTTGCGCAAATAACGGGGCCTACGGATGG
TTGCGCAAATAACGGGGCCTACGGTACGGA|GGGCCTACGGGTTCAGTATTCTACACAAGC
ACCTTGCGCAAATAACGGGGCCTACGGTAC|ACGGGGCCTACGGGTTCAGTATTCTACACA
GATCCTGTTCTAAAAGCATCTTGTATACCA|TTGCGCAAATAACGGGGCCTACGGTACGGA
ACACTATGACCAGTTACGTCCAACGAGGAC|GGGTGGGTACTGTTCCATGGCATGCCTACC
GCCTTAGACTCCTGTCTAATACTGGTCCCA|TGCTTGATACTCGAGTTATGCGCATTTCAC
TGGGCTCGCGAATCTGTATTCATTAAAGGA|GCTCTGTAAAGGTCATTGTGTACCACTGGT
GGGGCCTACGGTGAGCCGGCGTATGCATAG|CAGGTGGATAGAAGATCCTGTTCTAAAAGC
ATAACGGGGCCTACGGCTCGATATGTAGCC|CGACCCCGGCCTTCTCTGTTGCGGCATTGT
CTTCAGAGGACCTTGCGCAAATAACGGGGC|CCCGTCTAACTGAGGACCTTGCGCAAATAA
GCCTACGGGTTCAGTATTCTACACAAGCTT|GGACCTTGCGCAAATAACGGGGCCTACGGA
CGCAAATAACGGGGCCTACGGATGGCGTCG|GCGCAAATAACGGAGGACCTTGCGCAAATA
ATCACCCCCAGTATGCCCCGCGAGGGCTGA|CCGGCGTATGCATAGGACCTTGCGCAAATA
CTGTTCCATGGCATGCCTACCTGTTAGCTG|TGGAACCAAATCCACGAAGGACCTTGCGCA
GTAAATACCCTTTGTCGCATGCCCGAATTT|GACCATAAAAGGCAAGGGCCTGTGGGTGCG
GGGCCTACGGGGCCTACGGTAGTCGGGGTG|GCCTACGGTGGGGGGACTCGGAATGTGATA
AACGGAGGACCTTGCGCAAATAACGGGGCC|CGGAGGACCTTGCGCAAATAACGGGGCCTA
ACCCTTTGTCGCATGCCCGAATTTTAAGCA|AAAAGGCAAGGGCCTGTGGGTGCGTAATAT
GCATGCCCGAATTTTAAGCAGCGACCACCA|GGCCTGTGGGTGCGTAATATTCGCAAAGCA
CCTTGCGCAAATAACGGGGCCTACGGCACC|TACGGTAGTCGGGGTGCGCGAATGGGCTCG
CGGCATTGTCTATGTTCTCGGTCCACCTCC|TGCCCGAATTTTAAGCAGCGACCACCACGT
AAATAACGGGGCCTACGGTACGGAAAGGCA|ACGGGTTCAGTATTCTACACAAGCTTGGAT
AAATAACGGGGCCTACGGGTTCAGTATTCT|GCTGTATCGAGGACCTTGCGCAAATAACGG
CCTTGCGCAAATAACGGGGCCTACGGATGG|ACCTTGCGCAAATAACGGAGGACCTTGCGC
CAATGCTCCGCGCGTCCACGTATCACCCCC|AATAACGGGGCCTACGGTGAGCCGGCGTAT
GGACCTTGCGCAAATAACGGGGCCTACGGC|TCATTAAAGGACCTTGCGCAAATAACGGGG
GACATTGCACTGTTTTATTATTTTTCGTTC|CTAATATGTTGTGTTCCCGACAGTTGGCAG
GAAGGACCTTGCGCAAATAACGGGGCCAGG|CCTATACGCATCAAGGACCTTGCGCAAATA
AAATAGCTCTGTAAAGGTCATTGTGTACCA|GCACGACCCGACCGCCTTAGACTCCTGTCT
TCTTACGGCTGAGCCCTGTCCTCAACTGCA|AGAACACTATGACCAGTTACGTCCAACGAG
GGATAGAAGATCCTGTTCTAAAAGCATCTT|CCAGGACCTTGCGCAAATAACGGGGCCTAC
CTTTGTCGCATGCCCGAATTTTAAGCAGCG|AGGCAAGGGCCTGTGGGTGCGTAATATTCG
ACGTATCACCCCCAGTATGCCCCGCGAGGG|TGAGCCGGCGTATGCATAGGACCTTGCGCA
CCAACGAGGACCTTGCGCAAATAACGGGGC|GCATGCCTACCTGTTAGCTGTGAACCAGGT
ATGACCAGTTACGTCCAACGAGGACCTTGC|GGTACTGTTCCATGGCATGCCTACCTGTTA
AATTTTAAGCAGCGACCACCACGTTTGAAA|GTGCGTAATATTCGCAAAGCATACTCGGTA
GAGGACCTTGCGCAAATAACGGGGCCTACG|CGAGGACCTTGCGCAAATAACGGAGGACCT
ACGGTAGTCGGGGTGCGCGAATGGGCTCGC|ACTCGGAATGTGATACAAATAGCTCTGTAA
TGGGTACTGTTCCATGGCATGCCTACCTGT|TTGGAATGGAACCAAATCCACGAAGGACCT
GTGTCCTATGAAATAAGGAAGGTATGGTTA|TATGCAAGCCGGGGTTAAAGCAGACTGGGC
CTGAGCCCTGTCCTCAACTGCAAATTAGTA|ATGACCAGTTACGTCCAACGAGGACCTTGC
AAAGGACCTTGCGCAAATAACGGGGCCTAC|ACTGGTGCTCCGCGCCCGACCCCGGCCTTC
CGACAGTTGGCAGAACACTATGACCAGTTA|GCCTACGGGCCTACGGGTGGGTACTGTTCC
GAGAGCCTATACGCATCAAGGACCTTGCGC|GGACCTTGCGCAAATAACGGGGCCTACGGA
CTACGGTGGGGGGACTCGGAATGTGATACA|CCACTGATAGTCAGCGATTCTGTACTCGTG
TTTTATTATTTTTCGTTCTTACGGCTGAGC|GTTCCCGACAGTTGGCAGAACACTATGACC
GTCCAACGAGGACCTTGCGCAAATAACGGG|TGGCATGCCTACCTGTTAGCTGTGAACCAG
TAACGGGGCCTACGGCTCGATATGTAGCCG|GACCCCGGCCTTCTCTGTTGCGGCATTGTC
CCTACCTGTTAGCTGTGAACCAGGTGGATA|GAAGGACCTTGCGCAAATAACGGGGCCAGG
TTGCGCAAATAACGGGGCCTACGGCCCCGA|AAAGGACCTTGCGCAAATAACGGGGCCTAC
GGGGCCTACGGTAGTCGGGGTGCGCGAATG|TGGGGGGACTCGGAATGTGATACAAATAGC
GCGAGGGCTGATTTCATAATTCTAATATGT|TTGCGCAAATAACGGGAGGACCTTGCGCAA
CAAATAGCTCTGTAAAGGTCATTGTGTACC|TGCACGACCCGACCGCCTTAGACTCCTGTC
GCAAGCCGGGGTTAAAGCAGACTGGGCGGT|GCCGAAGGTGTGAGGACCTTGCGCAAATAA
CTACGGCTCGATATGTAGCCGGAGGACCTT|CTTCTCTGTTGCGGCATTGTCTATGTTCTC
TAGGACCTTGCGCAAATAACGGGAGGACCT|AGCATCTTGTATACCATAGGACCTTGCGCA
CGCAAATAACGGGGCCTACGGCTCGATATG|GCGCCCGACCCCGGCCTTCTCTGTTGCGGC
TCTGTACTCGTGCACGACCCGACCGCCTTA|TCCATCGAACGACACGTTTGCGACTGCTTG
GCTGTATCGAGGACCTTGCGCAAATAACGG|TACGGCCCCGAGGACCTTGCGCAAATAACG
CACGTCAGACATTGCACTGTTTTATTATTT|CATAATTCTAATATGTTGTGTTCCCGACAG
ATTCTGTACTCGTGCACGACCCGACCGCCT|CCTCCATCGAACGACACGTTTGCGACTGCT
CGCGCGCCAAACTTCAGAGGACCTTGCGCA|GGCCTACGGCACCCGTCTAACTGAGGACCT
AATATGTTGTGTTCCCGACAGTTGGCAGAA|TGCGCAAATAACGGGGCCTACGGGCCTACG
AGAGTCACATCACCTAAAAATCTCGAGAGC|GGTGAACGCGCGCCAAACTTCAGAGGACCT
GTGTACCACTGGTGCTCCGCGCCCGACCCC|TCCTGTCTAATACTGGTCCCACTGTGTAAA
GTCTAATACTGGTCCCACTGTGTAAATACC|AGTTATGCGCATTTCACTGAAGACCATAAA
CGCAAATAACGGGGCCTACGGCACCCGTCT|TAGTCGGGGTGCGCGAATGGGCTCGCGAAT
TGCGCAAATAACGGGGCCTACGGTGGGGGG|CGGTCCACCTCCATTTTCCACTGATAGTCA
GAGCCTATACGCATCAAGGACCTTGCGCAA|ACCTTGCGCAAATAACGGGGCCTACGGAGC
GATAGAAGATCCTGTTCTAAAAGCATCTTG|CAGGACCTTGCGCAAATAACGGGGCCTACG
TATGTTCTCGGTCCACCTCCATTTTCCACT|TTAAGCAGCGACCACCACGTTTGAAACGGC
CGGAGCTGTATCGAGGACCTTGCGCAAATA|GGCCTACGGCCCCGAGGACCTTGCGCAAAT
AGGAAGGTATGGTTAAGAGTCACATCACCT|TAAAGCAGACTGGGCGGTGAACGCGCGCCA
AGGCACGGTGTCCTATGAAATAAGGAAGGT|TGGATCCTATGCAAGCCGGGGTTAAAGCAG
CGATATGTAGCCGGAGGACCTTGCGCAAAT|TTGCGGCATTGTCTATGTTCTCGGTCCACC
AAGCCAATGCTCCGCGCGTCCACGTATCAC|CGCAAATAACGGGGCCTACGGTGAGCCGGC
AATAACGGAGGACCTTGCGCAAATAACGGG|AGCCGGAGGACCTTGCGCAAATAACGGGGC
AACGGGGCCTACGGCTCGATATGTAGCCGG|ACCCCGGCCTTCTCTGTTGCGGCATTGTCT
TGGATAGAAGATCCTGTTCTAAAAGCATCT|GCCAGGACCTTGCGCAAATAACGGGGCCTA
CAAATAACGGGGCCTACGGGTTCAGTATTC|AGCTGTATCGAGGACCTTGCGCAAATAACG
AGGACCTTGCGCAAATAACGGGAGGACCTT|GCATCTTGTATACCATAGGACCTTGCGCAA
CCCGACCCCGGCCTTCTCTGTTGCGGCATT|CTGTGTAAATACCCTTTGTCGCATGCCCGA
GAGCCCTGTCCTCAACTGCAAATTAGTAAG|GACCAGTTACGTCCAACGAGGACCTTGCGC
TCTAAAAGCATCTTGTATACCATAGGACCT|ATAACGGGGCCTACGGTACGGAAAGGCACG
TCCACGAAGGACCTTGCGCAAATAACGGGG|GAGAGCCTATACGCATCAAGGACCTTGCGC
CCTTGCGCAAATAACGGGGCCTACGGAGCT|TGAGGACCTTGCGCAAATAACGGGGCCTAC
CTGTCTAATACTGGTCCCACTGTGTAAATA|CGAGTTATGCGCATTTCACTGAAGACCATA
CATTGTCTATGTTCTCGGTCCACCTCCATT|CCGAATTTTAAGCAGCGACCACCACGTTTG
GTAGCCGGAGGACCTTGCGCAAATAACGGG|CATTGTCTATGTTCTCGGTCCACCTCCATT
AATAACGGGGCCTACGGGTCTGTCCCCCCA|TATGAAATAAGGAAGGTATGGTTAAGAGTC
TGGGGGGACTCGGAATGTGATACAAATAGC|ATAGTCAGCGATTCTGTACTCGTGCACGAC
GTATCACCCCCAGTATGCCCCGCGAGGGCT|AGCCGGCGTATGCATAGGACCTTGCGCAAA
TGTCTAATACTGGTCCCACTGTGTAAATAC|GAGTTATGCGCATTTCACTGAAGACCATAA
CCAATGCTCCGCGCGTCCACGTATCACCCC|AAATAACGGGGCCTACGGTGAGCCGGCGTA
GGTTAAGAGTCACATCACCTAAAAATCTCG|TGGGCGGTGAACGCGCGCCAAACTTCAGAG
GCCTACCTGTTAGCTGTGAACCAGGTGGAT|CGAAGGACCTTGCGCAAATAACGGGGCCAG
GTACTGTTCCATGGCATGCCTACCTGTTAG|GAATGGAACCAAATCCACGAAGGACCTTGC
CTACGGATGGCGTCGAGCCGAAGGTGTGAG|GACCTTGCGCAAATAACGGGGCCTACGGGG
ACCTTGCGCAAATAACGGGAGGACCTTGCG|TCTTGTATACCATAGGACCTTGCGCAAATA
ACCTTGCGCAAATAACGGGGCCTACGGATG|GACCTTGCGCAAATAACGGAGGACCTTGCG
GCGCAAATAACGGGGCCTACGGGCCTACGG|ATAACGGGGCCTACGGGTCTGTCCCCCCAG
TTAGACTCCTGTCTAATACTGGTCCCACTG|TTGATACTCGAGTTATGCGCATTTCACTGA
CATAGGACCTTGCGCAAATAACGGGGCCTA|GAAAGGCACGGTGTCCTATGAAATAAGGAA
TAAAGGTCATTGTGTACCACTGGTGCTCCG|CCGCCTTAGACTCCTGTCTAATACTGGTCC
CGAGGACCTTGCGCAAATAACGGGGCCTAC|CCGAGGACCTTGCGCAAATAACGGAGGACC
ACACAAGCTTGGATCCTATGCAAGCCGGGG|GGCCTACGGATGGCGTCGAGCCGAAGGTGT
TAGTCAGCGATTCTGTACTCGTGCACGACC|ACTTTCAGCCCTCCATCGAACGACACGTTT
CGCAAATAACGGGGCCTACGGGTCTGTCCC|GTCCTATGAAATAAGGAAGGTATGGTTAAG
TGTATTCATTAAAGGACCTTGCGCAAATAA|ATTGTGTACCACTGGTGCTCCGCGCCCGAC
GAGGACCTTGCGCAAATAACGGGGCCTACG|GGGCCTACGGTAGTCGGGGTGCGCGAATGG
GGGTGGGTACTGTTCCATGGCATGCCTACC|AGTTTGGAATGGAACCAAATCCACGAAGGA
TTCAGAGGACCTTGCGCAAATAACGGGGCC|CCGTCTAACTGAGGACCTTGCGCAAATAAC
CATAATTCTAATATGTTGTGTTCCCGACAG|GGAGGACCTTGCGCAAATAACGGGGCCTAC
ACGGGTCTGTCCCCCCAGTTTGGAATGGAA|AGGTATGGTTAAGAGTCACATCACCTAAAA
CCCCGGCCTTCTCTGTTGCGGCATTGTCTA|TAAATACCCTTTGTCGCATGCCCGAATTTT
GTCCCACTGTGTAAATACCCTTTGTCGCAT|TTTCACTGAAGACCATAAAAGGCAAGGGCC
CATCTTGTATACCATAGGACCTTGCGCAAA|GCCTACGGTACGGAAAGGCACGGTGTCCTA
CTGTATCGAGGACCTTGCGCAAATAACGGG|ACGGCCCCGAGGACCTTGCGCAAATAACGG
GTTTTATTATTTTTCGTTCTTACGGCTGAG|TGTTCCCGACAGTTGGCAGAACACTATGAC
CGGAGGACCTTGCGCAAATAACGGGGCCTA|TCTATGTTCTCGGTCCACCTCCATTTTCCA
AGGACCTTGCGCAAATAACGGGGCCTACGG|ATAACGGGGCCTACGGGTTCAGTATTCTAC
ATTTCATAATTCTAATATGTTGTGTTCCCG|AACGGGAGGACCTTGCGCAAATAACGGGGC
AGGACCTTGCGCAAATAACGGAGGACCTTG|CGGCTCGATATGTAGCCGGAGGACCTTGCG
AAATAACGGGGCCTACGGATGGCGTCGAGC|CAAATAACGGAGGACCTTGCGCAAATAACG
ACGGGTTCAGTATTCTACACAAGCTTGGAT|CTTGCGCAAATAACGGGGCCTACGGATGGC
CGGGGCCTACGGTACGGAAAGGCACGGTGT|TCAGTATTCTACACAAGCTTGGATCCTATG
GGGCGGTGAACGCGCGCCAAACTTCAGAGG|CAAATAACGGGGCCTACGGCACCCGTCTAA
ATATGTTGTGTTCCCGACAGTTGGCAGAAC|GCGCAAATAACGGGGCCTACGGGCCTACGG
GACCAGTTACGTCCAACGAGGACCTTGCGC|TACTGTTCCATGGCATGCCTACCTGTTAGC
GCGCAAATAACGGGGCCTACGGTACGGAAA|GCCTACGGGTTCAGTATTCTACACAAGCTT
CAACGAGGACCTTGCGCAAATAACGGGGCC|CATGCCTACCTGTTAGCTGTGAACCAGGTG
CGGGGTGCGCGAATGGGCTCGCGAATCTGT|TGTGATACAAATAGCTCTGTAAAGGTCATT
GGGCTCGCGAATCTGTATTCATTAAAGGAC|CTCTGTAAAGGTCATTGTGTACCACTGGTG
CTTGCGCAAATAACGGGGCCTACGGATGGC|CCTTGCGCAAATAACGGAGGACCTTGCGCA
CGCGAATGGGCTCGCGAATCTGTATTCATT|CAAATAGCTCTGTAAAGGTCATTGTGTACC
ACGACCCGACCGCCTTAGACTCCTGTCTAA|ACGTTTGCGACTGCTTGATACTCGAGTTAT
GACCTTGCGCAAATAACGGGGCCAGGACCT|TACGCATCAAGGACCTTGCGCAAATAACGG
AGAGCCTATACGCATCAAGGACCTTGCGCA|GACCTTGCGCAAATAACGGGGCCTACGGAG
AGTTGGCAGAACACTATGACCAGTTACGTC|ACGGGCCTACGGGTGGGTACTGTTCCATGG
GGACCTTGCGCAAATAACGGGGCCTACGGT|TAACGGGGCCTACGGGTTCAGTATTCTACA
GGAAGGTATGGTTAAGAGTCACATCACCTA|AAAGCAGACTGGGCGGTGAACGCGCGCCAA
GGACCTTGCGCAAATAACGGGGCCTACGGG|GGGCCTACGGAGCTGTATCGAGGACCTTGC
GGGGTGCGCGAATGGGCTCGCGAATCTGTA|GTGATACAAATAGCTCTGTAAAGGTCATTG
GTCTAACTGAGGACCTTGCGCAAATAACGG|GAATCTGTATTCATTAAAGGACCTTGCGCA
AGGACCTTGCGCAAATAACGGGGCCTACGG|TTCATTAAAGGACCTTGCGCAAATAACGGG
GTGGGTACTGTTCCATGGCATGCCTACCTG|TTTGGAATGGAACCAAATCCACGAAGGACC
ACCTTGCGCAAATAACGGGGCCTACGGGGC|CTTGCGCAAATAACGGGGCCTACGGTGGGG
GCGCCAAACTTCAGAGGACCTTGCGCAAAT|CTACGGCACCCGTCTAACTGAGGACCTTGC
TACGGAGCTGTATCGAGGACCTTGCGCAAA|GGGGCCTACGGCCCCGAGGACCTTGCGCAA
ACGGCTGAGCCCTGTCCTCAACTGCAAATT|CACTATGACCAGTTACGTCCAACGAGGACC
CAAATAACGGGGCCTACGGATGGCGTCGAG|GCAAATAACGGAGGACCTTGCGCAAATAAC
ATAGGACCTTGCGCAAATAACGGGGCCTAC|AAAGGCACGGTGTCCTATGAAATAAGGAAG
GAGGACCTTGCGCAAATAACGGAGGACCTT|ACGGCTCGATATGTAGCCGGAGGACCTTGC
CCGAAGGTGTGAGGACCTTGCGCAAATAAC|GGGGCCTACGGGGCCTACGGTAGTCGGGGT
TGTCCCCCCAGTTTGGAATGGAACCAAATC|GTTAAGAGTCACATCACCTAAAAATCTCGA
GGCCAGGACCTTGCGCAAATAACGGGGCCT|GCAAATAACGGGGCCTACGGGTTCAGTATT
GTCCACCTCCATTTTCCACTGATAGTCAGC|ACCACCACGTTTGAAACGGCCTACTTTCAG
ATAACGGAGGACCTTGCGCAAATAACGGGG|GCCGGAGGACCTTGCGCAAATAACGGGGCC
CGGTGAACGCGCGCCAAACTTCAGAGGACC|ATAACGGGGCCTACGGCACCCGTCTAACTG
GAACCAGGTGGATAGAAGATCCTGTTCTAA|ATAACGGGGCCAGGACCTTGCGCAAATAAC
GGCCTACGGATGGCGTCGAGCCGAAGGTGT|GAGGACCTTGCGCAAATAACGGGGCCTACG
TTCCCGACAGTTGGCAGAACACTATGACCA|CGGGGCCTACGGGCCTACGGGTGGGTACTG
GTGAGGACCTTGCGCAAATAACGGGGCCTA|CGGGGCCTACGGTAGTCGGGGTGCGCGAAT
GCGGTGAACGCGCGCCAAACTTCAGAGGAC|AATAACGGGGCCTACGGCACCCGTCTAACT
CGGCGTATGCATAGGACCTTGCGCAAATAA|CCTGTTCTAAAAGCATCTTGTATACCATAG
ACGGCTCGATATGTAGCCGGAGGACCTTGC|TCTCTGTTGCGGCATTGTCTATGTTCTCGG
ACCTTGCGCAAATAACGGGGCCTACGGCTC|TGCTCCGCGCCCGACCCCGGCCTTCTCTGT
AAATAACGGGGCCTACGGGCCTACGGGTGG|CGGGGCCTACGGGTCTGTCCCCCCAGTTTG
CAGTTTGGAATGGAACCAAATCCACGAAGG|TCACATCACCTAAAAATCTCGAGAGCCTAT
GGTGGATAGAAGATCCTGTTCTAAAAGCAT|GGGCCAGGACCTTGCGCAAATAACGGGGCC
GGGGGACTCGGAATGTGATACAAATAGCTC|AGTCAGCGATTCTGTACTCGTGCACGACCC
TGGCGTCGAGCCGAAGGTGTGAGGACCTTG|CGCAAATAACGGGGCCTACGGGGCCTACGG
CAAGCCGGGGTTAAAGCAGACTGGGCGGTG|CCGAAGGTGTGAGGACCTTGCGCAAATAAC
ATCCTGTTCTAAAAGCATCTTGTATACCAT|TGCGCAAATAACGGGGCCTACGGTACGGAA
GGGCCTACGGCACCCGTCTAACTGAGGACC|CGCGAATGGGCTCGCGAATCTGTATTCATT
TTAAGAGTCACATCACCTAAAAATCTCGAG|GGCGGTGAACGCGCGCCAAACTTCAGAGGA
ACCTTGCGCAAATAACGGGGCCTACGGGTT|GCCTACGGAGCTGTATCGAGGACCTTGCGC
GGGGCCTACGGTACGGAAAGGCACGGTGTC|CAGTATTCTACACAAGCTTGGATCCTATGC
GGAGGACCTTGCGCAAATAACGGGGCCTAC|CTATGTTCTCGGTCCACCTCCATTTTCCAC
CACCTAAAAATCTCGAGAGCCTATACGCAT|CGCCAAACTTCAGAGGACCTTGCGCAAATA
GGAGGACCTTGCGCAAATAACGGGGCCTAC|CCTTGCGCAAATAACGGGGCCTACGGGTCT
AGTAACGCACGTCAGACATTGCACTGTTTT|CTGATTTCATAATTCTAATATGTTGTGTTC
CTGAGGACCTTGCGCAAATAACGGGGCCTA|GTATTCATTAAAGGACCTTGCGCAAATAAC
TCTAACTGAGGACCTTGCGCAAATAACGGG|AATCTGTATTCATTAAAGGACCTTGCGCAA
CGGGGCCTACGGATGGCGTCGAGCCGAAGG|ACGGAGGACCTTGCGCAAATAACGGGGCCT
GGCCTACGGGGCCTACGGTAGTCGGGGTGC|CCTACGGTGGGGGGACTCGGAATGTGATAC
ACGGGGCCAGGACCTTGCGCAAATAACGGG|TTGCGCAAATAACGGGGCCTACGGGTTCAG
GACCGCCTTAGACTCCTGTCTAATACTGGT|CGACTGCTTGATACTCGAGTTATGCGCATT
CCTTCTCTGTTGCGGCATTGTCTATGTTCT|CCCTTTGTCGCATGCCCGAATTTTAAGCAG
GGAATGTGATACAAATAGCTCTGTAAAGGT|TTCTGTACTCGTGCACGACCCGACCGCCTT
AGGACCTTGCGCAAATAACGGGGCCTACGG|TGGTGCTCCGCGCCCGACCCCGGCCTTCTC
GTACCACTGGTGCTCCGCGCCCGACCCCGG|CTGTCTAATACTGGTCCCACTGTGTAAATA
ACTTCAGAGGACCTTGCGCAAATAACGGGG|ACCCGTCTAACTGAGGACCTTGCGCAAATA
TATACGCATCAAGGACCTTGCGCAAATAAC|GCGCAAATAACGGGGCCTACGGAGCTGTAT
TATTTTTCGTTCTTACGGCTGAGCCCTGTC|GACAGTTGGCAGAACACTATGACCAGTTAC
ACGTCCAACGAGGACCTTGCGCAAATAACG|CATGGCATGCCTACCTGTTAGCTGTGAACC
TAACGGGGCCTACGGGTTCAGTATTCTACA|GTATCGAGGACCTTGCGCAAATAACGGGGC
GGACCTTGCGCAAATAACGGGGCCTACGGA|AGGACCTTGCGCAAATAACGGAGGACCTTG
GACCTTGCGCAAATAACGGGGCCTACGGTG|GTTCTCGGTCCACCTCCATTTTCCACTGAT
ACCTTGCGCAAATAACGGGGCCTACGGCCC|ATTAAAGGACCTTGCGCAAATAACGGGGCC
GGGCCTACGGTACGGAAAGGCACGGTGTCC|AGTATTCTACACAAGCTTGGATCCTATGCA
CCTTGCGCAAATAACGGGGCCTACGGTGAG|CTGTTAGCTGTGAACCAGGTGGATAGAAGA
TATGAAATAAGGAAGGTATGGTTAAGAGTC|AGCCGGGGTTAAAGCAGACTGGGCGGTGAA
GTTACGTCCAACGAGGACCTTGCGCAAATA|TTCCATGGCATGCCTACCTGTTAGCTGTGA
GTCGAGCCGAAGGTGTGAGGACCTTGCGCA|AATAACGGGGCCTACGGGGCCTACGGTAGT
CGGGCCTACGGGTGGGTACTGTTCCATGGC|TGTCCCCCCAGTTTGGAATGGAACCAAATC
GGCCTACGGCTCGATATGTAGCCGGAGGAC|GGCCTTCTCTGTTGCGGCATTGTCTATGTT
GGCCCCGAGGACCTTGCGCAAATAACGGAG|GGGCCTACGGCTCGATATGTAGCCGGAGGA
GCTGATTTCATAATTCTAATATGTTGTGTT|AAATAACGGGAGGACCTTGCGCAAATAACG
TACGGGTCTGTCCCCCCAGTTTGGAATGGA|AAGGTATGGTTAAGAGTCACATCACCTAAA
CGGTGAGCCGGCGTATGCATAGGACCTTGC|TAGAAGATCCTGTTCTAAAAGCATCTTGTA
AATAACGGGGCCTACGGATGGCGTCGAGCC|AAATAACGGAGGACCTTGCGCAAATAACGG
GGCTCGATATGTAGCCGGAGGACCTTGCGC|TCTGTTGCGGCATTGTCTATGTTCTCGGTC
GGGGCCTACGGGTTCAGTATTCTACACAAG|CGAGGACCTTGCGCAAATAACGGGGCCTAC
CGCATGCCCGAATTTTAAGCAGCGACCACC|GGGCCTGTGGGTGCGTAATATTCGCAAAGC
TACGGAAAGGCACGGTGTCCTATGAAATAA|ACAAGCTTGGATCCTATGCAAGCCGGGGTT
GTGAACGCGCGCCAAACTTCAGAGGACCTT|AACGGGGCCTACGGCACCCGTCTAACTGAG
CATAGGACCTTGCGCAAATAACGGGAGGAC|AAAGCATCTTGTATACCATAGGACCTTGCG
TACGGCTCGATATGTAGCCGGAGGACCTTG|TTCTCTGTTGCGGCATTGTCTATGTTCTCG
AGCCGGGGTTAAAGCAGACTGGGCGGTGAA|GAAGGTGTGAGGACCTTGCGCAAATAACGG
ATAACGGGGCCTACGGGTCTGTCCCCCCAG|ATGAAATAAGGAAGGTATGGTTAAGAGTCA
TACCTGTTAGCTGTGAACCAGGTGGATAGA|AGGACCTTGCGCAAATAACGGGGCCAGGAC
AATAACGGGGCCAGGACCTTGCGCAAATAA|GACCTTGCGCAAATAACGGGGCCTACGGGT
AAGGCACGGTGTCCTATGAAATAAGGAAGG|TTGGATCCTATGCAAGCCGGGGTTAAAGCA
GAGTCACATCACCTAAAAATCTCGAGAGCC|GTGAACGCGCGCCAAACTTCAGAGGACCTT
CGCAAATAACGGGGCCTACGGAGCTGTATC|ACCTTGCGCAAATAACGGGGCCTACGGCCC
ACTGGGCGGTGAACGCGCGCCAAACTTCAG|GCGCAAATAACGGGGCCTACGGCACCCGTC
TGTCGCATGCCCGAATTTTAAGCAGCGACC|CAAGGGCCTGTGGGTGCGTAATATTCGCAA
AATAGCTCTGTAAAGGTCATTGTGTACCAC|CACGACCCGACCGCCTTAGACTCCTGTCTA
GCGTCGAGCCGAAGGTGTGAGGACCTTGCG|CAAATAACGGGGCCTACGGGGCCTACGGTA
CGGTGTCCTATGAAATAAGGAAGGTATGGT|CCTATGCAAGCCGGGGTTAAAGCAGACTGG
CTCGAGAGCCTATACGCATCAAGGACCTTG|AGAGGACCTTGCGCAAATAACGGGGCCTAC
CGCACGTCAGACATTGCACTGTTTTATTAT|TTCATAATTCTAATATGTTGTGTTCCCGAC
ATAACGGGGCCTACGGCACCCGTCTAACTG|GGGGTGCGCGAATGGGCTCGCGAATCTGTA
GCCTACGGTGGGGGGACTCGGAATGTGATA|TTCCACTGATAGTCAGCGATTCTGTACTCG
CGCAAATAACGGGAGGACCTTGCGCAAATA|ATACCATAGGACCTTGCGCAAATAACGGGG
TATGCATAGGACCTTGCGCAAATAACGGGA|TCTAAAAGCATCTTGTATACCATAGGACCT
CTCCGCGCCCGACCCCGGCCTTCTCTGTTG|GGTCCCACTGTGTAAATACCCTTTGTCGCA
ACTGTGTAAATACCCTTTGTCGCATGCCCG|CTGAAGACCATAAAAGGCAAGGGCCTGTGG
AGGTCATTGTGTACCACTGGTGCTCCGCGC|CCTTAGACTCCTGTCTAATACTGGTCCCAC
GCACTGTTTTATTATTTTTCGTTCTTACGG|TGTTGTGTTCCCGACAGTTGGCAGAACACT
ACTCGTGCACGACCCGACCGCCTTAGACTC|CGAACGACACGTTTGCGACTGCTTGATACT
TTGCGCAAATAACGGGGCCTACGGGCCTAC|AAATAACGGGGCCTACGGGTCTGTCCCCCC
GGATGGCGTCGAGCCGAAGGTGTGAGGACC|TTGCGCAAATAACGGGGCCTACGGGGCCTA
GCAAATAACGGGGCCTACGGGCCTACGGGT|AACGGGGCCTACGGGTCTGTCCCCCCAGTT
TACGCATCAAGGACCTTGCGCAAATAACGG|GCAAATAACGGGGCCTACGGAGCTGTATCG
CTCCGCGCGTCCACGTATCACCCCCAGTAT|CGGGGCCTACGGTGAGCCGGCGTATGCATA
AACGCACGTCAGACATTGCACTGTTTTATT|ATTTCATAATTCTAATATGTTGTGTTCCCG
AACGGGGCCTACGGTACGGAAAGGCACGGT|GTTCAGTATTCTACACAAGCTTGGATCCTA
AATAACGGGGCCTACGGGTTCAGTATTCTA|CTGTATCGAGGACCTTGCGCAAATAACGGG
CGCAAATAACGGAGGACCTTGCGCAAATAA|ATGTAGCCGGAGGACCTTGCGCAAATAACG
CCACGAAGGACCTTGCGCAAATAACGGGGC|AGAGCCTATACGCATCAAGGACCTTGCGCA
CCTACGGGTCTGTCCCCCCAGTTTGGAATG|GGAAGGTATGGTTAAGAGTCACATCACCTA
TACGGCACCCGTCTAACTGAGGACCTTGCG|ATGGGCTCGCGAATCTGTATTCATTAAAGG
ACCGCCTTAGACTCCTGTCTAATACTGGTC|GACTGCTTGATACTCGAGTTATGCGCATTT
CCCTGTCCTCAACTGCAAATTAGTAAGCCA|CAGTTACGTCCAACGAGGACCTTGCGCAAA
TCCCCCCAGTTTGGAATGGAACCAAATCCA|TAAGAGTCACATCACCTAAAAATCTCGAGA
AATACTGGTCCCACTGTGTAAATACCCTTT|ATGCGCATTTCACTGAAGACCATAAAAGGC
ACATCACCTAAAAATCTCGAGAGCCTATAC|CGCGCGCCAAACTTCAGAGGACCTTGCGCA
GTGTGAGGACCTTGCGCAAATAACGGGGCC|TACGGGGCCTACGGTAGTCGGGGTGCGCGA
GTGATACAAATAGCTCTGTAAAGGTCATTG|TACTCGTGCACGACCCGACCGCCTTAGACT
TCAGTATTCTACACAAGCTTGGATCCTATG|CAAATAACGGGGCCTACGGATGGCGTCGAG
ACATTGCACTGTTTTATTATTTTTCGTTCT|TAATATGTTGTGTTCCCGACAGTTGGCAGA
TTCTCTGTTGCGGCATTGTCTATGTTCTCG|CTTTGTCGCATGCCCGAATTTTAAGCAGCG
GGCCTACGGGTCTGTCCCCCCAGTTTGGAA|AAGGAAGGTATGGTTAAGAGTCACATCACC
ATCACCTAAAAATCTCGAGAGCCTATACGC|CGCGCCAAACTTCAGAGGACCTTGCGCAAA
ATCGAGGACCTTGCGCAAATAACGGGGCCT|CCCCGAGGACCTTGCGCAAATAACGGAGGA
AAATAACGGGGCCTACGGCCCCGAGGACCT|CCTTGCGCAAATAACGGGGCCTACGGCTCG
TGCCCCGCGAGGGCTGATTTCATAATTCTA|AGGACCTTGCGCAAATAACGGGAGGACCTT
AAGGAAGGTATGGTTAAGAGTCACATCACC|TTAAAGCAGACTGGGCGGTGAACGCGCGCC
CCTACGGGTGGGTACTGTTCCATGGCATGC|CCCCCAGTTTGGAATGGAACCAAATCCACG
CGGCTCGATATGTAGCCGGAGGACCTTGCG|CTCTGTTGCGGCATTGTCTATGTTCTCGGT
AAATAACGGGGCCTACGGCACCCGTCTAAC|TCGGGGTGCGCGAATGGGCTCGCGAATCTG
CCTGTTAGCTGTGAACCAGGTGGATAGAAG|GACCTTGCGCAAATAACGGGGCCAGGACCT
GGGCCTACGGTGAGCCGGCGTATGCATAGG|AGGTGGATAGAAGATCCTGTTCTAAAAGCA
AACTTCAGAGGACCTTGCGCAAATAACGGG|CACCCGTCTAACTGAGGACCTTGCGCAAAT
TTATTATTTTTCGTTCTTACGGCTGAGCCC|TCCCGACAGTTGGCAGAACACTATGACCAG
GCCGGCGTATGCATAGGACCTTGCGCAAAT|ATCCTGTTCTAAAAGCATCTTGTATACCAT
ACCAGGTGGATAGAAGATCCTGTTCTAAAA|AACGGGGCCAGGACCTTGCGCAAATAACGG
ATAACGGGGCCTACGGTGGGGGGACTCGGA|CCTCCATTTTCCACTGATAGTCAGCGATTC
GTATTCATTAAAGGACCTTGCGCAAATAAC|TTGTGTACCACTGGTGCTCCGCGCCCGACC
GCGTATGCATAGGACCTTGCGCAAATAACG|TGTTCTAAAAGCATCTTGTATACCATAGGA
GGACCTTGCGCAAATAACGGGAGGACCTTG|CATCTTGTATACCATAGGACCTTGCGCAAA
TTTATTATTTTTCGTTCTTACGGCTGAGCC|TTCCCGACAGTTGGCAGAACACTATGACCA
ACCTAAAAATCTCGAGAGCCTATACGCATC|GCCAAACTTCAGAGGACCTTGCGCAAATAA
TCCATTTTCCACTGATAGTCAGCGATTCTG|CGTTTGAAACGGCCTACTTTCAGCCCTCCA
CCTACGGGTTCAGTATTCTACACAAGCTTG|GACCTTGCGCAAATAACGGGGCCTACGGAT
CGCGAATCTGTATTCATTAAAGGACCTTGC|TAAAGGTCATTGTGTACCACTGGTGCTCCG
CTTGCGCAAATAACGGGGCCTACGGCACCC|ACGGTAGTCGGGGTGCGCGAATGGGCTCGC
CGCAAATAACGGGGCCTACGGGGCCTACGG|CAAATAACGGGGCCTACGGTGGGGGGACTC
AGCCTATACGCATCAAGGACCTTGCGCAAA|CCTTGCGCAAATAACGGGGCCTACGGAGCT
TGCGCAAATAACGGGGCCTACGGAGCTGTA|GGACCTTGCGCAAATAACGGGGCCTACGGC
AGCCGGCGTATGCATAGGACCTTGCGCAAA|GATCCTGTTCTAAAAGCATCTTGTATACCA
TATTCATTAAAGGACCTTGCGCAAATAACG|TGTGTACCACTGGTGCTCCGCGCCCGACCC
TGTTGTGTTCCCGACAGTTGGCAGAACACT|CAAATAACGGGGCCTACGGGCCTACGGGTG
GCGCAAATAACGGGGCCTACGGGTCTGTCC|TGTCCTATGAAATAAGGAAGGTATGGTTAA
GACCTTGCGCAAATAACGGGGCCTACGGGT|GCACGGTGTCCTATGAAATAAGGAAGGTAT
CACGAAGGACCTTGCGCAAATAACGGGGCC|GAGCCTATACGCATCAAGGACCTTGCGCAA
TAAGCCAATGCTCCGCGCGTCCACGTATCA|GCGCAAATAACGGGGCCTACGGTGAGCCGG
ACTGTTTTATTATTTTTCGTTCTTACGGCT|TTGTGTTCCCGACAGTTGGCAGAACACTAT
CGTATGCATAGGACCTTGCGCAAATAACGG|GTTCTAAAAGCATCTTGTATACCATAGGAC
CGGGGCCTACGGCTCGATATGTAGCCGGAG|CCCGGCCTTCTCTGTTGCGGCATTGTCTAT
CCAAACTTCAGAGGACCTTGCGCAAATAAC|CGGCACCCGTCTAACTGAGGACCTTGCGCA
TATTATTTTTCGTTCTTACGGCTGAGCCCT|CCCGACAGTTGGCAGAACACTATGACCAGT
GACCTTGCGCAAATAACGGGGCCTACGGCT|GTGCTCCGCGCCCGACCCCGGCCTTCTCTG
GTCGGGGTGCGCGAATGGGCTCGCGAATCT|AATGTGATACAAATAGCTCTGTAAAGGTCA
GGTCCCACTGTGTAAATACCCTTTGTCGCA|ATTTCACTGAAGACCATAAAAGGCAAGGGC
TCTCGGTCCACCTCCATTTTCCACTGATAG|CAGCGACCACCACGTTTGAAACGGCCTACT
CCCGAGGACCTTGCGCAAATAACGGAGGAC|CCTACGGCTCGATATGTAGCCGGAGGACCT
AGCAGACTGGGCGGTGAACGCGCGCCAAAC|ACCTTGCGCAAATAACGGGGCCTACGGCAC
TAACGGGAGGACCTTGCGCAAATAACGGGG|TAGGACCTTGCGCAAATAACGGGGCCTACG
TTTTCCACTGATAGTCAGCGATTCTGTACT|TGAAACGGCCTACTTTCAGCCCTCCATCGA
CGGGGCCAGGACCTTGCGCAAATAACGGGG|TGCGCAAATAACGGGGCCTACGGGTTCAGT
ACGGGGCCTACGGCCCCGAGGACCTTGCGC|CGCAAATAACGGGGCCTACGGCTCGATATG
AGGACCTTGCGCAAATAACGGGGCCTACGG|AGGCACGGTGTCCTATGAAATAAGGAAGGT
TTTTAAGCAGCGACCACCACGTTTGAAACG|GCGTAATATTCGCAAAGCATACTCGGTATG
CGAGGACCTTGCGCAAATAACGGGGCCTAC|GCCTACCTGTTAGCTGTGAACCAGGTGGAT
AGCGATTCTGTACTCGTGCACGACCCGACC|CAGCCCTCCATCGAACGACACGTTTGCGAC
AAATAACGGGGCCTACGGAGCTGTATCGAG|TTGCGCAAATAACGGGGCCTACGGCCCCGA
AATAACGGGGCCTACGGCACCCGTCTAACT|CGGGGTGCGCGAATGGGCTCGCGAATCTGT
ATAACGGGAGGACCTTGCGCAAATAACGGG|ATAGGACCTTGCGCAAATAACGGGGCCTAC
GGCCTACGGCACCCGTCTAACTGAGGACCT|GCGAATGGGCTCGCGAATCTGTATTCATTA
TGCAAGCCGGGGTTAAAGCAGACTGGGCGG|AGCCGAAGGTGTGAGGACCTTGCGCAAATA
GAATCTGTATTCATTAAAGGACCTTGCGCA|AGGTCATTGTGTACCACTGGTGCTCCGCGC
CTTACGGCTGAGCCCTGTCCTCAACTGCAA|GAACACTATGACCAGTTACGTCCAACGAGG
GTTAGCTGTGAACCAGGTGGATAGAAGATC|CTTGCGCAAATAACGGGGCCAGGACCTTGC
GCGCAAATAACGGGGCCTACGGCCCCGAGG|AGGACCTTGCGCAAATAACGGGGCCTACGG
TAAAGCAGACTGGGCGGTGAACGCGCGCCA|AGGACCTTGCGCAAATAACGGGGCCTACGG
CACCCGTCTAACTGAGGACCTTGCGCAAAT|CTCGCGAATCTGTATTCATTAAAGGACCTT
ACGGTGTCCTATGAAATAAGGAAGGTATGG|TCCTATGCAAGCCGGGGTTAAAGCAGACTG
CCCAGTATGCCCCGCGAGGGCTGATTTCAT|TATGCATAGGACCTTGCGCAAATAACGGGA
AAGCAGACTGGGCGGTGAACGCGCGCCAAA|GACCTTGCGCAAATAACGGGGCCTACGGCA
GGGTACTGTTCCATGGCATGCCTACCTGTT|TGGAATGGAACCAAATCCACGAAGGACCTT
TTGCGCAAATAACGGGAGGACCTTGCGCAA|TGTATACCATAGGACCTTGCGCAAATAACG
ATGTTGTGTTCCCGACAGTTGGCAGAACAC|GCAAATAACGGGGCCTACGGGCCTACGGGT
AAATAAGGAAGGTATGGTTAAGAGTCACAT|GGGGTTAAAGCAGACTGGGCGGTGAACGCG
CGTCGAGCCGAAGGTGTGAGGACCTTGCGC|AAATAACGGGGCCTACGGGGCCTACGGTAG
ATAGGACCTTGCGCAAATAACGGGAGGACC|AAGCATCTTGTATACCATAGGACCTTGCGC
GCATCTTGTATACCATAGGACCTTGCGCAA|GGCCTACGGTACGGAAAGGCACGGTGTCCT
TGCGCAAATAACGGGGCCTACGGATGGCGT|TTGCGCAAATAACGGAGGACCTTGCGCAAA
GACCTTGCGCAAATAACGGGGCCTACGGCA|CCTACGGTAGTCGGGGTGCGCGAATGGGCT
CCCCCAGTATGCCCCGCGAGGGCTGATTTC|CGTATGCATAGGACCTTGCGCAAATAACGG
AGTTACGTCCAACGAGGACCTTGCGCAAAT|GTTCCATGGCATGCCTACCTGTTAGCTGTG
CAGGACCTTGCGCAAATAACGGGGCCTACG|AATAACGGGGCCTACGGGTTCAGTATTCTA
GTGGGGGGACTCGGAATGTGATACAAATAG|GATAGTCAGCGATTCTGTACTCGTGCACGA
ATAACGGGGCCTACGGCCCCGAGGACCTTG|TTGCGCAAATAACGGGGCCTACGGCTCGAT
GTTGCGGCATTGTCTATGTTCTCGGTCCAC|CGCATGCCCGAATTTTAAGCAGCGACCACC
AAACTTCAGAGGACCTTGCGCAAATAACGG|GCACCCGTCTAACTGAGGACCTTGCGCAAA
TTCATAATTCTAATATGTTGTGTTCCCGAC|CGGGAGGACCTTGCGCAAATAACGGGGCCT
CCTTAGACTCCTGTCTAATACTGGTCCCAC|GCTTGATACTCGAGTTATGCGCATTTCACT
GCGCAAATAACGGGGCCTACGGTGGGGGGA|GGTCCACCTCCATTTTCCACTGATAGTCAG
CGCAAATAACGGGGCCTACGGGTTCAGTAT|GGAGCTGTATCGAGGACCTTGCGCAAATAA
AAGCTTGGATCCTATGCAAGCCGGGGTTAA|TACGGATGGCGTCGAGCCGAAGGTGTGAGG
TTGTATACCATAGGACCTTGCGCAAATAAC|ACGGTACGGAAAGGCACGGTGTCCTATGAA
GCCTACGGTAGTCGGGGTGCGCGAATGGGC|GGGGACTCGGAATGTGATACAAATAGCTCT
CAGTTACGTCCAACGAGGACCTTGCGCAAA|TGTTCCATGGCATGCCTACCTGTTAGCTGT
CTTAGACTCCTGTCTAATACTGGTCCCACT|CTTGATACTCGAGTTATGCGCATTTCACTG
TCGGTCCACCTCCATTTTCCACTGATAGTC|GCGACCACCACGTTTGAAACGGCCTACTTT
CTGTAAAGGTCATTGTGTACCACTGGTGCT|CGACCGCCTTAGACTCCTGTCTAATACTGG
ATAAGGAAGGTATGGTTAAGAGTCACATCA|GGTTAAAGCAGACTGGGCGGTGAACGCGCG
GACCTTGCGCAAATAACGGGGCCTACGGTG|ACCTGTTAGCTGTGAACCAGGTGGATAGAA
CCCGACCGCCTTAGACTCCTGTCTAATACT|TTGCGACTGCTTGATACTCGAGTTATGCGC
GGTAGTCGGGGTGCGCGAATGGGCTCGCGA|TCGGAATGTGATACAAATAGCTCTGTAAAG
GGGGACTCGGAATGTGATACAAATAGCTCT|GTCAGCGATTCTGTACTCGTGCACGACCCG
ACCCGTCTAACTGAGGACCTTGCGCAAATA|TCGCGAATCTGTATTCATTAAAGGACCTTG
GTACGGAAAGGCACGGTGTCCTATGAAATA|CACAAGCTTGGATCCTATGCAAGCCGGGGT
AATTAGTAAGCCAATGCTCCGCGCGTCCAC|GACCTTGCGCAAATAACGGGGCCTACGGTG
CCGACAGTTGGCAGAACACTATGACCAGTT|GGCCTACGGGCCTACGGGTGGGTACTGTTC
TGTATACCATAGGACCTTGCGCAAATAACG|CGGTACGGAAAGGCACGGTGTCCTATGAAA
AAAGCAGACTGGGCGGTGAACGCGCGCCAA|GGACCTTGCGCAAATAACGGGGCCTACGGC
CCTACGGTGGGGGGACTCGGAATGTGATAC|TCCACTGATAGTCAGCGATTCTGTACTCGT
GCCTACGGCCCCGAGGACCTTGCGCAAATA|ATAACGGGGCCTACGGCTCGATATGTAGCC
TCCTCAACTGCAAATTAGTAAGCCAATGCT|ACGTCCAACGAGGACCTTGCGCAAATAACG
GCGAATGGGCTCGCGAATCTGTATTCATTA|AAATAGCTCTGTAAAGGTCATTGTGTACCA
ACGGAAAGGCACGGTGTCCTATGAAATAAG|CAAGCTTGGATCCTATGCAAGCCGGGGTTA
ACTGCAAATTAGTAAGCCAATGCTCCGCGC|AACGAGGACCTTGCGCAAATAACGGGGCCT
GAGGACCTTGCGCAAATAACGGGGCCTACG|CTTGCGCAAATAACGGGGCCTACGGGTCTG
CTAAAAGCATCTTGTATACCATAGGACCTT|TAACGGGGCCTACGGTACGGAAAGGCACGG
TACGTCCAACGAGGACCTTGCGCAAATAAC|CCATGGCATGCCTACCTGTTAGCTGTGAAC
TCACATCACCTAAAAATCTCGAGAGCCTAT|AACGCGCGCCAAACTTCAGAGGACCTTGCG
GGACCTTGCGCAAATAACGGGGCCTACGGA|AACTGAGGACCTTGCGCAAATAACGGGGCC
ATGGCATGCCTACCTGTTAGCTGTGAACCA|AAATCCACGAAGGACCTTGCGCAAATAACG
AGCCCTGTCCTCAACTGCAAATTAGTAAGC|ACCAGTTACGTCCAACGAGGACCTTGCGCA
CCTACGGCACCCGTCTAACTGAGGACCTTG|GAATGGGCTCGCGAATCTGTATTCATTAAA
GGGTGCGCGAATGGGCTCGCGAATCTGTAT|TGATACAAATAGCTCTGTAAAGGTCATTGT
CCGACCGCCTTAGACTCCTGTCTAATACTG|TGCGACTGCTTGATACTCGAGTTATGCGCA
GGCTGATTTCATAATTCTAATATGTTGTGT|CAAATAACGGGAGGACCTTGCGCAAATAAC
GCAGACTGGGCGGTGAACGCGCGCCAAACT|CCTTGCGCAAATAACGGGGCCTACGGCACC
TTCCACTGATAGTCAGCGATTCTGTACTCG|AAACGGCCTACTTTCAGCCCTCCATCGAAC
ACCTTGCGCAAATAACGGAGGACCTTGCGC|CTCGATATGTAGCCGGAGGACCTTGCGCAA
CGACCGCCTTAGACTCCTGTCTAATACTGG|GCGACTGCTTGATACTCGAGTTATGCGCAT
CTACGGGTGGGTACTGTTCCATGGCATGCC|CCCCAGTTTGGAATGGAACCAAATCCACGA
GTGTTCCCGACAGTTGGCAGAACACTATGA|TAACGGGGCCTACGGGCCTACGGGTGGGTA
GACTCCTGTCTAATACTGGTCCCACTGTGT|ATACTCGAGTTATGCGCATTTCACTGAAGA
GATACAAATAGCTCTGTAAAGGTCATTGTG|CTCGTGCACGACCCGACCGCCTTAGACTCC
ACGGGGCCTACGGGTTCAGTATTCTACACA|ATCGAGGACCTTGCGCAAATAACGGGGCCT
GTGCGCGAATGGGCTCGCGAATCTGTATTC|ATACAAATAGCTCTGTAAAGGTCATTGTGT
GAACGCGCGCCAAACTTCAGAGGACCTTGC|CGGGGCCTACGGCACCCGTCTAACTGAGGA
TCTATGTTCTCGGTCCACCTCCATTTTCCA|TTTTAAGCAGCGACCACCACGTTTGAAACG
GTCATTGTGTACCACTGGTGCTCCGCGCCC|TTAGACTCCTGTCTAATACTGGTCCCACTG
ATGCCCCGCGAGGGCTGATTTCATAATTCT|TAGGACCTTGCGCAAATAACGGGAGGACCT
GACCTTGCGCAAATAACGGGGCCTACGGTA|AACGGGGCCTACGGGTTCAGTATTCTACAC
AAGGACCTTGCGCAAATAACGGGGCCTACG|CGGGGCCTACGGAGCTGTATCGAGGACCTT
TCCTATGCAAGCCGGGGTTAAAGCAGACTG|CGTCGAGCCGAAGGTGTGAGGACCTTGCGC
CCTACGGATGGCGTCGAGCCGAAGGTGTGA|GGACCTTGCGCAAATAACGGGGCCTACGGG
CGGGGTTAAAGCAGACTGGGCGGTGAACGC|GGTGTGAGGACCTTGCGCAAATAACGGGGC
GTTAAAGCAGACTGGGCGGTGAACGCGCGC|TGAGGACCTTGCGCAAATAACGGGGCCTAC
GTTTGGAATGGAACCAAATCCACGAAGGAC|ACATCACCTAAAAATCTCGAGAGCCTATAC
TGATTTCATAATTCTAATATGTTGTGTTCC|ATAACGGGAGGACCTTGCGCAAATAACGGG
GTCCTCAACTGCAAATTAGTAAGCCAATGC|TACGTCCAACGAGGACCTTGCGCAAATAAC
TTGCGCAAATAACGGGGCCTACGGTGGGGG|TCGGTCCACCTCCATTTTCCACTGATAGTC
CTGGTGCTCCGCGCCCGACCCCGGCCTTCT|AATACTGGTCCCACTGTGTAAATACCCTTT
TCTAATATGTTGTGTTCCCGACAGTTGGCA|CCTTGCGCAAATAACGGGGCCTACGGGCCT
ACTATGACCAGTTACGTCCAACGAGGACCT|GTGGGTACTGTTCCATGGCATGCCTACCTG
TGCTCCGCGCCCGACCCCGGCCTTCTCTGT|CTGGTCCCACTGTGTAAATACCCTTTGTCG
TTGTGTACCACTGGTGCTCCGCGCCCGACC|ACTCCTGTCTAATACTGGTCCCACTGTGTA
AGCCAATGCTCCGCGCGTCCACGTATCACC|GCAAATAACGGGGCCTACGGTGAGCCGGCG
CGGGGCCTACGGGTCTGTCCCCCCAGTTTG|AATAAGGAAGGTATGGTTAAGAGTCACATC
GTTGTGTTCCCGACAGTTGGCAGAACACTA|AAATAACGGGGCCTACGGGCCTACGGGTGG
TTGCGCAAATAACGGGGCCTACGGCACCCG|CGGTAGTCGGGGTGCGCGAATGGGCTCGCG
AATTCTAATATGTTGTGTTCCCGACAGTTG|GGACCTTGCGCAAATAACGGGGCCTACGGG
TACGGTGGGGGGACTCGGAATGTGATACAA|CACTGATAGTCAGCGATTCTGTACTCGTGC
GATAGTCAGCGATTCTGTACTCGTGCACGA|CTACTTTCAGCCCTCCATCGAACGACACGT
TTAAAGGACCTTGCGCAAATAACGGGGCCT|CCACTGGTGCTCCGCGCCCGACCCCGGCCT
ACGGAGCTGTATCGAGGACCTTGCGCAAAT|GGGCCTACGGCCCCGAGGACCTTGCGCAAA
GAGCCGAAGGTGTGAGGACCTTGCGCAAAT|AACGGGGCCTACGGGGCCTACGGTAGTCGG
CTCGTGCACGACCCGACCGCCTTAGACTCC|GAACGACACGTTTGCGACTGCTTGATACTC
AGGACCTTGCGCAAATAACGGGGCCTACGG|GACCTTGCGCAAATAACGGGGCCTACGGTG
CACATCACCTAAAAATCTCGAGAGCCTATA|ACGCGCGCCAAACTTCAGAGGACCTTGCGC
CGGGTTCAGTATTCTACACAAGCTTGGATC|TTGCGCAAATAACGGGGCCTACGGATGGCG
GAGGACCTTGCGCAAATAACGGGGCCTACG|GGACCTTGCGCAAATAACGGGGCCTACGGT
CTTGCGCAAATAACGGGGCCTACGGTGAGC|TGTTAGCTGTGAACCAGGTGGATAGAAGAT
GAAGATCCTGTTCTAAAAGCATCTTGTATA|ACCTTGCGCAAATAACGGGGCCTACGGTAC
GCAAATAACGGAGGACCTTGCGCAAATAAC|TGTAGCCGGAGGACCTTGCGCAAATAACGG
ATTGTGTACCACTGGTGCTCCGCGCCCGAC|GACTCCTGTCTAATACTGGTCCCACTGTGT
GAACCAAATCCACGAAGGACCTTGCGCAAA|AAAATCTCGAGAGCCTATACGCATCAAGGA
TAATATGTTGTGTTCCCGACAGTTGGCAGA|TTGCGCAAATAACGGGGCCTACGGGCCTAC
CTTGCGCAAATAACGGGGCCTACGGGGCCT|TGCGCAAATAACGGGGCCTACGGTGGGGGG
AAATAACGGGGCCTACGGCTCGATATGTAG|CCCGACCCCGGCCTTCTCTGTTGCGGCATT
TTGGCAGAACACTATGACCAGTTACGTCCA|GGGCCTACGGGTGGGTACTGTTCCATGGCA
GCCAGGACCTTGCGCAAATAACGGGGCCTA|CAAATAACGGGGCCTACGGGTTCAGTATTC
TGTCCTATGAAATAAGGAAGGTATGGTTAA|ATGCAAGCCGGGGTTAAAGCAGACTGGGCG
GGGGCCTACGGGCCTACGGGTGGGTACTGT|TACGGGTCTGTCCCCCCAGTTTGGAATGGA
ATAACGGGGCCTACGGTGAGCCGGCGTATG|TGAACCAGGTGGATAGAAGATCCTGTTCTA
GGTGAGCCGGCGTATGCATAGGACCTTGCG|AGAAGATCCTGTTCTAAAAGCATCTTGTAT
ATCTTGTATACCATAGGACCTTGCGCAAAT|CCTACGGTACGGAAAGGCACGGTGTCCTAT
GTACTCGTGCACGACCCGACCGCCTTAGAC|ATCGAACGACACGTTTGCGACTGCTTGATA
ACCTCCATTTTCCACTGATAGTCAGCGATT|CCACGTTTGAAACGGCCTACTTTCAGCCCT
GCAAATAACGGGGCCTACGGCACCCGTCTA|AGTCGGGGTGCGCGAATGGGCTCGCGAATC
AGGTGGATAGAAGATCCTGTTCTAAAAGCA|GGGGCCAGGACCTTGCGCAAATAACGGGGC
ACGGTGGGGGGACTCGGAATGTGATACAAA|ACTGATAGTCAGCGATTCTGTACTCGTGCA
ACCATAGGACCTTGCGCAAATAACGGGGCC|CGGAAAGGCACGGTGTCCTATGAAATAAGG
CGGGGCCTACGGGCCTACGGGTGGGTACTG|CTACGGGTCTGTCCCCCCAGTTTGGAATGG
TTGTCTATGTTCTCGGTCCACCTCCATTTT|GAATTTTAAGCAGCGACCACCACGTTTGAA
CAAATAACGGGGCCTACGGGCCTACGGGTG|ACGGGGCCTACGGGTCTGTCCCCCCAGTTT
CCTGTCCTCAACTGCAAATTAGTAAGCCAA|AGTTACGTCCAACGAGGACCTTGCGCAAAT
ACGGGCCTACGGGTGGGTACTGTTCCATGG|CTGTCCCCCCAGTTTGGAATGGAACCAAAT
GGACCTTGCGCAAATAACGGGGCCTACGGC|GGTGCTCCGCGCCCGACCCCGGCCTTCTCT
GCTGTGAACCAGGTGGATAGAAGATCCTGT|CGCAAATAACGGGGCCAGGACCTTGCGCAA
ACGGGGCCTACGGTAGTCGGGGTGCGCGAA|GGTGGGGGGACTCGGAATGTGATACAAATA
TATCGAGGACCTTGCGCAAATAACGGGGCC|GCCCCGAGGACCTTGCGCAAATAACGGAGG
CCCGACAGTTGGCAGAACACTATGACCAGT|GGGCCTACGGGCCTACGGGTGGGTACTGTT
TTCTGTACTCGTGCACGACCCGACCGCCTT|CTCCATCGAACGACACGTTTGCGACTGCTT
TTTCCACTGATAGTCAGCGATTCTGTACTC|GAAACGGCCTACTTTCAGCCCTCCATCGAA
CGCAAATAACGGGGCCTACGGTGAGCCGGC|AGCTGTGAACCAGGTGGATAGAAGATCCTG
TGCGGCATTGTCTATGTTCTCGGTCCACCT|CATGCCCGAATTTTAAGCAGCGACCACCAC
GCCTACGGAGCTGTATCGAGGACCTTGCGC|AACGGGGCCTACGGCCCCGAGGACCTTGCG
CCTTGCGCAAATAACGGGGCCAGGACCTTG|CGCATCAAGGACCTTGCGCAAATAACGGGG
TATGTTGTGTTCCCGACAGTTGGCAGAACA|CGCAAATAACGGGGCCTACGGGCCTACGGG
GGACCTTGCGCAAATAACGGGGCCTACGGG|ACCTTGCGCAAATAACGGGGCCTACGGTGG
GCCTACGGCTCGATATGTAGCCGGAGGACC|GCCTTCTCTGTTGCGGCATTGTCTATGTTC
GGACCTTGCGCAAATAACGGGGCCTACGGG|TGCGCAAATAACGGGGCCTACGGGTCTGTC
GGCTCGCGAATCTGTATTCATTAAAGGACC|TCTGTAAAGGTCATTGTGTACCACTGGTGC
CAAATAACGGGGCCTACGGCCCCGAGGACC|ACCTTGCGCAAATAACGGGGCCTACGGCTC
TGCCTACCTGTTAGCTGTGAACCAGGTGGA|ACGAAGGACCTTGCGCAAATAACGGGGCCA
ATTATTTTTCGTTCTTACGGCTGAGCCCTG|CCGACAGTTGGCAGAACACTATGACCAGTT
CGCGCGTCCACGTATCACCCCCAGTATGCC|GGCCTACGGTGAGCCGGCGTATGCATAGGA
CTAATACTGGTCCCACTGTGTAAATACCCT|TTATGCGCATTTCACTGAAGACCATAAAAG
CTGTTAGCTGTGAACCAGGTGGATAGAAGA|ACCTTGCGCAAATAACGGGGCCAGGACCTT
CCGGCGTATGCATAGGACCTTGCGCAAATA|TCCTGTTCTAAAAGCATCTTGTATACCATA
GCGCAAATAACGGGGCCTACGGCTCGATAT|CGCGCCCGACCCCGGCCTTCTCTGTTGCGG
CTATGCAAGCCGGGGTTAAAGCAGACTGGG|TCGAGCCGAAGGTGTGAGGACCTTGCGCAA
CCTTTGTCGCATGCCCGAATTTTAAGCAGC|AAGGCAAGGGCCTGTGGGTGCGTAATATTC
TAACGGGGCCTACGGTACGGAAAGGCACGG|GGTTCAGTATTCTACACAAGCTTGGATCCT
GTCTATGTTCTCGGTCCACCTCCATTTTCC|ATTTTAAGCAGCGACCACCACGTTTGAAAC
CTCTGTTGCGGCATTGTCTATGTTCTCGGT|TTGTCGCATGCCCGAATTTTAAGCAGCGAC
CCCCAGTATGCCCCGCGAGGGCTGATTTCA|GTATGCATAGGACCTTGCGCAAATAACGGG
TGGAATGGAACCAAATCCACGAAGGACCTT|TCACCTAAAAATCTCGAGAGCCTATACGCA
TGCGCAAATAACGGAGGACCTTGCGCAAAT|ATATGTAGCCGGAGGACCTTGCGCAAATAA
CTAAAAATCTCGAGAGCCTATACGCATCAA|CAAACTTCAGAGGACCTTGCGCAAATAACG
GTGGATAGAAGATCCTGTTCTAAAAGCATC|GGCCAGGACCTTGCGCAAATAACGGGGCCT
GAAATAAGGAAGGTATGGTTAAGAGTCACA|CGGGGTTAAAGCAGACTGGGCGGTGAACGC
GGGGCCTACGGTGGGGGGACTCGGAATGTG|ATTTTCCACTGATAGTCAGCGATTCTGTAC
GGCTGAGCCCTGTCCTCAACTGCAAATTAG|CTATGACCAGTTACGTCCAACGAGGACCTT
CTGGGCGGTGAACGCGCGCCAAACTTCAGA|CGCAAATAACGGGGCCTACGGCACCCGTCT
AGAACACTATGACCAGTTACGTCCAACGAG|TACGGGTGGGTACTGTTCCATGGCATGCCT
TCGCATGCCCGAATTTTAAGCAGCGACCAC|AGGGCCTGTGGGTGCGTAATATTCGCAAAG
GCAAATAACGGGGCCTACGGAGCTGTATCG|CCTTGCGCAAATAACGGGGCCTACGGCCCC
GTTCTAAAAGCATCTTGTATACCATAGGAC|AAATAACGGGGCCTACGGTACGGAAAGGCA
AACGGGGCCTACGGATGGCGTCGAGCCGAA|TAACGGAGGACCTTGCGCAAATAACGGGGC
ACCTGTTAGCTGTGAACCAGGTGGATAGAA|GGACCTTGCGCAAATAACGGGGCCAGGACC
CGTGCACGACCCGACCGCCTTAGACTCCTG|ACGACACGTTTGCGACTGCTTGATACTCGA
CAAATAACGGGGCCAGGACCTTGCGCAAAT|AGGACCTTGCGCAAATAACGGGGCCTACGG
CCAGGTGGATAGAAGATCCTGTTCTAAAAG|ACGGGGCCAGGACCTTGCGCAAATAACGGG
CGATTCTGTACTCGTGCACGACCCGACCGC|GCCCTCCATCGAACGACACGTTTGCGACTG
CACGTATCACCCCCAGTATGCCCCGCGAGG|GTGAGCCGGCGTATGCATAGGACCTTGCGC
TGTACTCGTGCACGACCCGACCGCCTTAGA|CATCGAACGACACGTTTGCGACTGCTTGAT
TGCGCAAATAACGGGGCCAGGACCTTGCGC|ATCAAGGACCTTGCGCAAATAACGGGGCCT
CTTGCGCAAATAACGGGGCCTACGGTGGGG|CTCGGTCCACCTCCATTTTCCACTGATAGT
TCTCGAGAGCCTATACGCATCAAGGACCTT|CAGAGGACCTTGCGCAAATAACGGGGCCTA
CAAATCCACGAAGGACCTTGCGCAAATAAC|TCTCGAGAGCCTATACGCATCAAGGACCTT
TTATTTTTCGTTCTTACGGCTGAGCCCTGT|CGACAGTTGGCAGAACACTATGACCAGTTA
CGGGGCCTACGGCACCCGTCTAACTGAGGA|TGCGCGAATGGGCTCGCGAATCTGTATTCA
CTGTTCTAAAAGCATCTTGTATACCATAGG|GCAAATAACGGGGCCTACGGTACGGAAAGG
TTGCACTGTTTTATTATTTTTCGTTCTTAC|TATGTTGTGTTCCCGACAGTTGGCAGAACA
CTGTCCTCAACTGCAAATTAGTAAGCCAAT|GTTACGTCCAACGAGGACCTTGCGCAAATA
GCATAGGACCTTGCGCAAATAACGGGAGGA|AAAAGCATCTTGTATACCATAGGACCTTGC
TGTGTTCCCGACAGTTGGCAGAACACTATG|ATAACGGGGCCTACGGGCCTACGGGTGGGT
TGAACCAGGTGGATAGAAGATCCTGTTCTA|AATAACGGGGCCAGGACCTTGCGCAAATAA
TGTACCACTGGTGCTCCGCGCCCGACCCCG|CCTGTCTAATACTGGTCCCACTGTGTAAAT
CTTCTCTGTTGCGGCATTGTCTATGTTCTC|CCTTTGTCGCATGCCCGAATTTTAAGCAGC
AATAACGGGGCCTACGGCTCGATATGTAGC|CCGACCCCGGCCTTCTCTGTTGCGGCATTG
ACAAGCTTGGATCCTATGCAAGCCGGGGTT|CCTACGGATGGCGTCGAGCCGAAGGTGTGA
CAGTATGCCCCGCGAGGGCTGATTTCATAA|TGCATAGGACCTTGCGCAAATAACGGGAGG
TTTTCGTTCTTACGGCTGAGCCCTGTCCTC|AGTTGGCAGAACACTATGACCAGTTACGTC
TAGCCGGAGGACCTTGCGCAAATAACGGGG|ATTGTCTATGTTCTCGGTCCACCTCCATTT
GACCTTGCGCAAATAACGGGGCCTACGGAT|GGACCTTGCGCAAATAACGGAGGACCTTGC
ACTGGTCCCACTGTGTAAATACCCTTTGTC|CGCATTTCACTGAAGACCATAAAAGGCAAG
ACCTTGCGCAAATAACGGGGCCTACGGTGA|CCTGTTAGCTGTGAACCAGGTGGATAGAAG
CCTATGCAAGCCGGGGTTAAAGCAGACTGG|GTCGAGCCGAAGGTGTGAGGACCTTGCGCA
GGGCCTACGGCCCCGAGGACCTTGCGCAAA|AAATAACGGGGCCTACGGCTCGATATGTAG
GCCCCGCGAGGGCTGATTTCATAATTCTAA|GGACCTTGCGCAAATAACGGGAGGACCTTG
GCTCGCGAATCTGTATTCATTAAAGGACCT|CTGTAAAGGTCATTGTGTACCACTGGTGCT
ACGGGGCCTACGGTGGGGGGACTCGGAATG|CCATTTTCCACTGATAGTCAGCGATTCTGT
CGGGGCCTACGGAGCTGTATCGAGGACCTT|AAATAACGGGGCCTACGGCCCCGAGGACCT
TGCGCAAATAACGGGGCCTACGGGTTCAGT|ACGGAGCTGTATCGAGGACCTTGCGCAAAT
TACGGTAGTCGGGGTGCGCGAATGGGCTCG|GACTCGGAATGTGATACAAATAGCTCTGTA
CCTTGCGCAAATAACGGGGCCTACGGGCCT|GCAAATAACGGGGCCTACGGGTCTGTCCCC
TCATAATTCTAATATGTTGTGTTCCCGACA|GGGAGGACCTTGCGCAAATAACGGGGCCTA
TGATACAAATAGCTCTGTAAAGGTCATTGT|ACTCGTGCACGACCCGACCGCCTTAGACTC
CAGTATTCTACACAAGCTTGGATCCTATGC|AAATAACGGGGCCTACGGATGGCGTCGAGC
GCACCCGTCTAACTGAGGACCTTGCGCAAA|GCTCGCGAATCTGTATTCATTAAAGGACCT
TTGCGCAAATAACGGGGCCTACGGATGGCG|CTTGCGCAAATAACGGAGGACCTTGCGCAA
GTCCTATGAAATAAGGAAGGTATGGTTAAG|TGCAAGCCGGGGTTAAAGCAGACTGGGCGG
ACGGTGAGCCGGCGTATGCATAGGACCTTG|ATAGAAGATCCTGTTCTAAAAGCATCTTGT
ACCTTGCGCAAATAACGGGGCCTACGGTGG|TTCTCGGTCCACCTCCATTTTCCACTGATA
CCTACGGTACGGAAAGGCACGGTGTCCTAT|ATTCTACACAAGCTTGGATCCTATGCAAGC
GCGCAAATAACGGGGCCTACGGCACCCGTC|GTAGTCGGGGTGCGCGAATGGGCTCGCGAA
CGAGGGCTGATTTCATAATTCTAATATGTT|TGCGCAAATAACGGGAGGACCTTGCGCAAA
CTTGCGCAAATAACGGGGCCAGGACCTTGC|GCATCAAGGACCTTGCGCAAATAACGGGGC
ACGGATGGCGTCGAGCCGAAGGTGTGAGGA|CCTTGCGCAAATAACGGGGCCTACGGGGCC
TGCGCAAATAACGGGGCCTACGGTACGGAA|GGCCTACGGGTTCAGTATTCTACACAAGCT
TTCTAAAAGCATCTTGTATACCATAGGACC|AATAACGGGGCCTACGGTACGGAAAGGCAC
CGTCCACGTATCACCCCCAGTATGCCCCGC|TACGGTGAGCCGGCGTATGCATAGGACCTT
GAAGGTATGGTTAAGAGTCACATCACCTAA|AAGCAGACTGGGCGGTGAACGCGCGCCAAA
GGAACCAAATCCACGAAGGACCTTGCGCAA|AAAAATCTCGAGAGCCTATACGCATCAAGG
CAAATAACGGGGCCTACGGTACGGAAAGGC|TACGGGTTCAGTATTCTACACAAGCTTGGA
TCCTGTTCTAAAAGCATCTTGTATACCATA|GCGCAAATAACGGGGCCTACGGTACGGAAA
ATTCATTAAAGGACCTTGCGCAAATAACGG|GTGTACCACTGGTGCTCCGCGCCCGACCCC
GGCCTACGGGTTCAGTATTCTACACAAGCT|AGGACCTTGCGCAAATAACGGGGCCTACGG
CGGAAAGGCACGGTGTCCTATGAAATAAGG|AAGCTTGGATCCTATGCAAGCCGGGGTTAA
AATCTCGAGAGCCTATACGCATCAAGGACC|TTCAGAGGACCTTGCGCAAATAACGGGGCC
GCCTACGGTGAGCCGGCGTATGCATAGGAC|GTGGATAGAAGATCCTGTTCTAAAAGCATC
TATCACCCCCAGTATGCCCCGCGAGGGCTG|GCCGGCGTATGCATAGGACCTTGCGCAAAT
AGTTTGGAATGGAACCAAATCCACGAAGGA|CACATCACCTAAAAATCTCGAGAGCCTATA
AGGACCTTGCGCAAATAACGGGGCCTACGG|TAACTGAGGACCTTGCGCAAATAACGGGGC
GTTCAGTATTCTACACAAGCTTGGATCCTA|CGCAAATAACGGGGCCTACGGATGGCGTCG
AAGGTCATTGTGTACCACTGGTGCTCCGCG|GCCTTAGACTCCTGTCTAATACTGGTCCCA
GCCTACGGGGCCTACGGTAGTCGGGGTGCG|CTACGGTGGGGGGACTCGGAATGTGATACA
CAGAGGACCTTGCGCAAATAACGGGGCCTA|GTCTAACTGAGGACCTTGCGCAAATAACGG
TAGCTGTGAACCAGGTGGATAGAAGATCCT|TGCGCAAATAACGGGGCCAGGACCTTGCGC
CGGGGCCTACGGGGCCTACGGTAGTCGGGG|GGGCCTACGGTGGGGGGACTCGGAATGTGA
GGACCTTGCGCAAATAACGGGGCCAGGACC|ATACGCATCAAGGACCTTGCGCAAATAACG
AATCCACGAAGGACCTTGCGCAAATAACGG|TCGAGAGCCTATACGCATCAAGGACCTTGC
TGGTTAAGAGTCACATCACCTAAAAATCTC|CTGGGCGGTGAACGCGCGCCAAACTTCAGA
TAACGGGGCCTACGGAGCTGTATCGAGGAC|CGCAAATAACGGGGCCTACGGCCCCGAGGA
GGGACTCGGAATGTGATACAAATAGCTCTG|TCAGCGATTCTGTACTCGTGCACGACCCGA
TAACGGAGGACCTTGCGCAAATAACGGGGC|CCGGAGGACCTTGCGCAAATAACGGGGCCT
GCAAATTAGTAAGCCAATGCTCCGCGCGTC|GAGGACCTTGCGCAAATAACGGGGCCTACG
CAGTTGGCAGAACACTATGACCAGTTACGT|TACGGGCCTACGGGTGGGTACTGTTCCATG
TGCATAGGACCTTGCGCAAATAACGGGAGG|TAAAAGCATCTTGTATACCATAGGACCTTG
CGCGCCAAACTTCAGAGGACCTTGCGCAAA|CCTACGGCACCCGTCTAACTGAGGACCTTG
TACGGCCCCGAGGACCTTGCGCAAATAACG|ACGGGGCCTACGGCTCGATATGTAGCCGGA
TGTTGCGGCATTGTCTATGTTCTCGGTCCA|TCGCATGCCCGAATTTTAAGCAGCGACCAC
TACGGGGCCTACGGTAGTCGGGGTGCGCGA|CGGTGGGGGGACTCGGAATGTGATACAAAT
GGGCCTACGGTGGGGGGACTCGGAATGTGA|TTTTCCACTGATAGTCAGCGATTCTGTACT
CGCGTCCACGTATCACCCCCAGTATGCCCC|CCTACGGTGAGCCGGCGTATGCATAGGACC
GCAAATAACGGGGCCTACGGGGCCTACGGT|AAATAACGGGGCCTACGGTGGGGGGACTCG
GGGCTGATTTCATAATTCTAATATGTTGTG|GCAAATAACGGGAGGACCTTGCGCAAATAA
CGCCCGACCCCGGCCTTCTCTGTTGCGGCA|CACTGTGTAAATACCCTTTGTCGCATGCCC
CATGGCATGCCTACCTGTTAGCTGTGAACC|CAAATCCACGAAGGACCTTGCGCAAATAAC
GCCCGACCCCGGCCTTCTCTGTTGCGGCAT|ACTGTGTAAATACCCTTTGTCGCATGCCCG
AAATAACGGGGCCTACGGTGAGCCGGCGTA|TGTGAACCAGGTGGATAGAAGATCCTGTTC
GATTTCATAATTCTAATATGTTGTGTTCCC|TAACGGGAGGACCTTGCGCAAATAACGGGG
AAGGACCTTGCGCAAATAACGGGGCCTACG|CTGGTGCTCCGCGCCCGACCCCGGCCTTCT
CATCACCTAAAAATCTCGAGAGCCTATACG|GCGCGCCAAACTTCAGAGGACCTTGCGCAA
ATAATTCTAATATGTTGTGTTCCCGACAGT|GAGGACCTTGCGCAAATAACGGGGCCTACG
CCGCGAGGGCTGATTTCATAATTCTAATAT|CCTTGCGCAAATAACGGGAGGACCTTGCGC
GTCCCCCCAGTTTGGAATGGAACCAAATCC|TTAAGAGTCACATCACCTAAAAATCTCGAG
ATGCATAGGACCTTGCGCAAATAACGGGAG|CTAAAAGCATCTTGTATACCATAGGACCTT
GCATTGTCTATGTTCTCGGTCCACCTCCAT|CCCGAATTTTAAGCAGCGACCACCACGTTT
TCTGTTGCGGCATTGTCTATGTTCTCGGTC|TGTCGCATGCCCGAATTTTAAGCAGCGACC
CGGTAGTCGGGGTGCGCGAATGGGCTCGCG|CTCGGAATGTGATACAAATAGCTCTGTAAA
CAACTGCAAATTAGTAAGCCAATGCTCCGC|CCAACGAGGACCTTGCGCAAATAACGGGGC
ATTTTCCACTGATAGTCAGCGATTCTGTAC|TTGAAACGGCCTACTTTCAGCCCTCCATCG
GCAAATAACGGGGCCTACGGTGGGGGGACT|TCCACCTCCATTTTCCACTGATAGTCAGCG
GTATGCCCCGCGAGGGCTGATTTCATAATT|CATAGGACCTTGCGCAAATAACGGGAGGAC
CTGTGAACCAGGTGGATAGAAGATCCTGTT|GCAAATAACGGGGCCAGGACCTTGCGCAAA
CACGACCCGACCGCCTTAGACTCCTGTCTA|CACGTTTGCGACTGCTTGATACTCGAGTTA
ATGTGATACAAATAGCTCTGTAAAGGTCAT|TGTACTCGTGCACGACCCGACCGCCTTAGA
GCGATTCTGTACTCGTGCACGACCCGACCG|AGCCCTCCATCGAACGACACGTTTGCGACT
TGAGCCGGCGTATGCATAGGACCTTGCGCA|AAGATCCTGTTCTAAAAGCATCTTGTATAC
TCACCCCCAGTATGCCCCGCGAGGGCTGAT|CGGCGTATGCATAGGACCTTGCGCAAATAA
GCAGAACACTATGACCAGTTACGTCCAACG|CCTACGGGTGGGTACTGTTCCATGGCATGC
TCTACACAAGCTTGGATCCTATGCAAGCCG|CGGGGCCTACGGATGGCGTCGAGCCGAAGG
TTAGCTGTGAACCAGGTGGATAGAAGATCC|TTGCGCAAATAACGGGGCCAGGACCTTGCG
CGAATGGGCTCGCGAATCTGTATTCATTAA|AATAGCTCTGTAAAGGTCATTGTGTACCAC
CCTTGCGCAAATAACGGGGCCTACGGGTTC|CCTACGGAGCTGTATCGAGGACCTTGCGCA
CTACCTGTTAGCTGTGAACCAGGTGGATAG|AAGGACCTTGCGCAAATAACGGGGCCAGGA
TATTCTACACAAGCTTGGATCCTATGCAAG|TAACGGGGCCTACGGATGGCGTCGAGCCGA
GCTCCGCGCCCGACCCCGGCCTTCTCTGTT|TGGTCCCACTGTGTAAATACCCTTTGTCGC
ATTGCACTGTTTTATTATTTTTCGTTCTTA|ATATGTTGTGTTCCCGACAGTTGGCAGAAC
AACGGGGCCTACGGTGGGGGGACTCGGAAT|TCCATTTTCCACTGATAGTCAGCGATTCTG
CTTGCGCAAATAACGGAGGACCTTGCGCAA|CGATATGTAGCCGGAGGACCTTGCGCAAAT
GAAGGTGTGAGGACCTTGCGCAAATAACGG|GGCCTACGGGGCCTACGGTAGTCGGGGTGC
TAAAAGCATCTTGTATACCATAGGACCTTG|AACGGGGCCTACGGTACGGAAAGGCACGGT
CCAAATCCACGAAGGACCTTGCGCAAATAA|ATCTCGAGAGCCTATACGCATCAAGGACCT
TGACCAGTTACGTCCAACGAGGACCTTGCG|GTACTGTTCCATGGCATGCCTACCTGTTAG
TAAATACCCTTTGTCGCATGCCCGAATTTT|ACCATAAAAGGCAAGGGCCTGTGGGTGCGT
TCGAGAGCCTATACGCATCAAGGACCTTGC|GAGGACCTTGCGCAAATAACGGGGCCTACG
GGCAGAACACTATGACCAGTTACGTCCAAC|GCCTACGGGTGGGTACTGTTCCATGGCATG
GCAAATAACGGGGCCTACGGTACGGAAAGG|CTACGGGTTCAGTATTCTACACAAGCTTGG
CGGGGCCTACGGTAGTCGGGGTGCGCGAAT|GTGGGGGGACTCGGAATGTGATACAAATAG
TGTTCTAAAAGCATCTTGTATACCATAGGA|CAAATAACGGGGCCTACGGTACGGAAAGGC
GCAAATAACGGGGCCTACGGATGGCGTCGA|CGCAAATAACGGAGGACCTTGCGCAAATAA
GGCGTCGAGCCGAAGGTGTGAGGACCTTGC|GCAAATAACGGGGCCTACGGGGCCTACGGT
CCGTCTAACTGAGGACCTTGCGCAAATAAC|GCGAATCTGTATTCATTAAAGGACCTTGCG
TTCTCGGTCCACCTCCATTTTCCACTGATA|GCAGCGACCACCACGTTTGAAACGGCCTAC
CGGATGGCGTCGAGCCGAAGGTGTGAGGAC|CTTGCGCAAATAACGGGGCCTACGGGGCCT
CAAATAACGGGGCCTACGGTGGGGGGACTC|CCACCTCCATTTTCCACTGATAGTCAGCGA
TAGAAGATCCTGTTCTAAAAGCATCTTGTA|GGACCTTGCGCAAATAACGGGGCCTACGGT
TAGTAAGCCAATGCTCCGCGCGTCCACGTA|CTTGCGCAAATAACGGGGCCTACGGTGAGC
TGCGCAAATAACGGGGCCTACGGCTCGATA|CCGCGCCCGACCCCGGCCTTCTCTGTTGCG
GCCAATGCTCCGCGCGTCCACGTATCACCC|CAAATAACGGGGCCTACGGTGAGCCGGCGT
TCCCACTGTGTAAATACCCTTTGTCGCATG|TTCACTGAAGACCATAAAAGGCAAGGGCCT
AGTCGGGGTGCGCGAATGGGCTCGCGAATC|GAATGTGATACAAATAGCTCTGTAAAGGTC
GTGAGCCGGCGTATGCATAGGACCTTGCGC|GAAGATCCTGTTCTAAAAGCATCTTGTATA
GCGCAAATAACGGGAGGACCTTGCGCAAAT|TATACCATAGGACCTTGCGCAAATAACGGG
CTATGAAATAAGGAAGGTATGGTTAAGAGT|AAGCCGGGGTTAAAGCAGACTGGGCGGTGA
ATAGAAGATCCTGTTCTAAAAGCATCTTGT|AGGACCTTGCGCAAATAACGGGGCCTACGG
GTAGTCGGGGTGCGCGAATGGGCTCGCGAA|CGGAATGTGATACAAATAGCTCTGTAAAGG
ACGGGGCCTACGGGTCTGTCCCCCCAGTTT|AAATAAGGAAGGTATGGTTAAGAGTCACAT
GGGTTCAGTATTCTACACAAGCTTGGATCC|TGCGCAAATAACGGGGCCTACGGATGGCGT
ATTAGTAAGCCAATGCTCCGCGCGTCCACG|ACCTTGCGCAAATAACGGGGCCTACGGTGA
GGACCTTGCGCAAATAACGGAGGACCTTGC|GGCTCGATATGTAGCCGGAGGACCTTGCGC
ATGTTCTCGGTCCACCTCCATTTTCCACTG|TAAGCAGCGACCACCACGTTTGAAACGGCC
ATGGCGTCGAGCCGAAGGTGTGAGGACCTT|GCGCAAATAACGGGGCCTACGGGGCCTACG
AATGGAACCAAATCCACGAAGGACCTTGCG|CCTAAAAATCTCGAGAGCCTATACGCATCA
TTCATTAAAGGACCTTGCGCAAATAACGGG|TGTACCACTGGTGCTCCGCGCCCGACCCCG
AGCCGAAGGTGTGAGGACCTTGCGCAAATA|ACGGGGCCTACGGGGCCTACGGTAGTCGGG
AGGACCTTGCGCAAATAACGGGGCCTACGG|TTGCGCAAATAACGGGGCCTACGGGTCTGT
CCACCTCCATTTTCCACTGATAGTCAGCGA|CACCACGTTTGAAACGGCCTACTTTCAGCC
GCAAATAACGGGAGGACCTTGCGCAAATAA|TACCATAGGACCTTGCGCAAATAACGGGGC
AAATAACGGGAGGACCTTGCGCAAATAACG|CCATAGGACCTTGCGCAAATAACGGGGCCT
GTCGCATGCCCGAATTTTAAGCAGCGACCA|AAGGGCCTGTGGGTGCGTAATATTCGCAAA
CCACGTATCACCCCCAGTATGCCCCGCGAG|GGTGAGCCGGCGTATGCATAGGACCTTGCG
TCATTAAAGGACCTTGCGCAAATAACGGGG|GTACCACTGGTGCTCCGCGCCCGACCCCGG
ATACCCTTTGTCGCATGCCCGAATTTTAAG|ATAAAAGGCAAGGGCCTGTGGGTGCGTAAT
GTGAACCAGGTGGATAGAAGATCCTGTTCT|AAATAACGGGGCCAGGACCTTGCGCAAATA
GAGCTGTATCGAGGACCTTGCGCAAATAAC|CCTACGGCCCCGAGGACCTTGCGCAAATAA
CAAGCTTGGATCCTATGCAAGCCGGGGTTA|CTACGGATGGCGTCGAGCCGAAGGTGTGAG
TAACGGGGCCTACGGGCCTACGGGTGGGTA|GGCCTACGGGTCTGTCCCCCCAGTTTGGAA
GCCCTGTCCTCAACTGCAAATTAGTAAGCC|CCAGTTACGTCCAACGAGGACCTTGCGCAA
AAATAACGGGGCCTACGGGGCCTACGGTAG|ATAACGGGGCCTACGGTGGGGGGACTCGGA
TAACGGGGCCAGGACCTTGCGCAAATAACG|CCTTGCGCAAATAACGGGGCCTACGGGTTC
CATGCCCGAATTTTAAGCAGCGACCACCAC|GCCTGTGGGTGCGTAATATTCGCAAAGCAT
AGGACCTTGCGCAAATAACGGGGCCTACGG|ATGTTCTCGGTCCACCTCCATTTTCCACTG
ATTTTTCGTTCTTACGGCTGAGCCCTGTCC|ACAGTTGGCAGAACACTATGACCAGTTACG
ATGCAAGCCGGGGTTAAAGCAGACTGGGCG|GAGCCGAAGGTGTGAGGACCTTGCGCAAAT
TCAACTGCAAATTAGTAAGCCAATGCTCCG|TCCAACGAGGACCTTGCGCAAATAACGGGG
TCGAGGACCTTGCGCAAATAACGGGGCCTA|CCCGAGGACCTTGCGCAAATAACGGAGGAC
GGGGCCTACGGCACCCGTCTAACTGAGGAC|GCGCGAATGGGCTCGCGAATCTGTATTCAT
ATAACGGGGCCAGGACCTTGCGCAAATAAC|ACCTTGCGCAAATAACGGGGCCTACGGGTT
ATAGCTCTGTAAAGGTCATTGTGTACCACT|ACGACCCGACCGCCTTAGACTCCTGTCTAA
AACTGAGGACCTTGCGCAAATAACGGGGCC|CTGTATTCATTAAAGGACCTTGCGCAAATA
GGGGCCTACGGCCCCGAGGACCTTGCGCAA|CAAATAACGGGGCCTACGGCTCGATATGTA
GAACACTATGACCAGTTACGTCCAACGAGG|ACGGGTGGGTACTGTTCCATGGCATGCCTA
GTTCCCGACAGTTGGCAGAACACTATGACC|ACGGGGCCTACGGGCCTACGGGTGGGTACT
CCTAAAAATCTCGAGAGCCTATACGCATCA|CCAAACTTCAGAGGACCTTGCGCAAATAAC
AATAACGGGGCCTACGGGGCCTACGGTAGT|TAACGGGGCCTACGGTGGGGGGACTCGGAA
AGTATGCCCCGCGAGGGCTGATTTCATAAT|GCATAGGACCTTGCGCAAATAACGGGAGGA
TACCCTTTGTCGCATGCCCGAATTTTAAGC|TAAAAGGCAAGGGCCTGTGGGTGCGTAATA
ATACGCATCAAGGACCTTGCGCAAATAACG|CGCAAATAACGGGGCCTACGGAGCTGTATC
GGCCTACGGCCCCGAGGACCTTGCGCAAAT|AATAACGGGGCCTACGGCTCGATATGTAGC
CTATACGCATCAAGGACCTTGCGCAAATAA|TGCGCAAATAACGGGGCCTACGGAGCTGTA
AGATCCTGTTCTAAAAGCATCTTGTATACC|CTTGCGCAAATAACGGGGCCTACGGTACGG
TAGCTCTGTAAAGGTCATTGTGTACCACTG|CGACCCGACCGCCTTAGACTCCTGTCTAAT
ATTTTAAGCAGCGACCACCACGTTTGAAAC|TGCGTAATATTCGCAAAGCATACTCGGTAT
CGCCAAACTTCAGAGGACCTTGCGCAAATA|TACGGCACCCGTCTAACTGAGGACCTTGCG
CTATGACCAGTTACGTCCAACGAGGACCTT|TGGGTACTGTTCCATGGCATGCCTACCTGT
CCTATGAAATAAGGAAGGTATGGTTAAGAG|CAAGCCGGGGTTAAAGCAGACTGGGCGGTG
CGCAAATAACGGGGCCAGGACCTTGCGCAA|CAAGGACCTTGCGCAAATAACGGGGCCTAC
CATTAAAGGACCTTGCGCAAATAACGGGGC|TACCACTGGTGCTCCGCGCCCGACCCCGGC
TAATTCTAATATGTTGTGTTCCCGACAGTT|AGGACCTTGCGCAAATAACGGGGCCTACGG
CCGACCCCGGCCTTCTCTGTTGCGGCATTG|TGTGTAAATACCCTTTGTCGCATGCCCGAA
CTACACAAGCTTGGATCCTATGCAAGCCGG|GGGGCCTACGGATGGCGTCGAGCCGAAGGT
TCCGCGCCCGACCCCGGCCTTCTCTGTTGC|GTCCCACTGTGTAAATACCCTTTGTCGCAT
AATGGGCTCGCGAATCTGTATTCATTAAAG|TAGCTCTGTAAAGGTCATTGTGTACCACTG
CCAGTTTGGAATGGAACCAAATCCACGAAG|GTCACATCACCTAAAAATCTCGAGAGCCTA
CCTACGGGCCTACGGGTGGGTACTGTTCCA|GGTCTGTCCCCCCAGTTTGGAATGGAACCA
AGTCACATCACCTAAAAATCTCGAGAGCCT|TGAACGCGCGCCAAACTTCAGAGGACCTTG
AATAAGGAAGGTATGGTTAAGAGTCACATC|GGGTTAAAGCAGACTGGGCGGTGAACGCGC
TGCGCGAATGGGCTCGCGAATCTGTATTCA|TACAAATAGCTCTGTAAAGGTCATTGTGTA
CTTGTATACCATAGGACCTTGCGCAAATAA|TACGGTACGGAAAGGCACGGTGTCCTATGA
CGAAGGTGTGAGGACCTTGCGCAAATAACG|GGGCCTACGGGGCCTACGGTAGTCGGGGTG
ACCTTGCGCAAATAACGGGGCCTACGGGTC|CACGGTGTCCTATGAAATAAGGAAGGTATG
ACCCCGGCCTTCTCTGTTGCGGCATTGTCT|GTAAATACCCTTTGTCGCATGCCCGAATTT
CCCCGAGGACCTTGCGCAAATAACGGAGGA|GCCTACGGCTCGATATGTAGCCGGAGGACC
GGTCATTGTGTACCACTGGTGCTCCGCGCC|CTTAGACTCCTGTCTAATACTGGTCCCACT
TGTGAACCAGGTGGATAGAAGATCCTGTTC|CAAATAACGGGGCCAGGACCTTGCGCAAAT
CTAACTGAGGACCTTGCGCAAATAACGGGG|ATCTGTATTCATTAAAGGACCTTGCGCAAA
GTGTAAATACCCTTTGTCGCATGCCCGAAT|AAGACCATAAAAGGCAAGGGCCTGTGGGTG
ACCTTGCGCAAATAACGGGGCCTACGGCAC|CTACGGTAGTCGGGGTGCGCGAATGGGCTC
AAATCCACGAAGGACCTTGCGCAAATAACG|CTCGAGAGCCTATACGCATCAAGGACCTTG
ATTCTAATATGTTGTGTTCCCGACAGTTGG|GACCTTGCGCAAATAACGGGGCCTACGGGC
TTTTTCGTTCTTACGGCTGAGCCCTGTCCT|CAGTTGGCAGAACACTATGACCAGTTACGT
TGTGTAAATACCCTTTGTCGCATGCCCGAA|GAAGACCATAAAAGGCAAGGGCCTGTGGGT
TTACGTCCAACGAGGACCTTGCGCAAATAA|TCCATGGCATGCCTACCTGTTAGCTGTGAA
GCCTTCTCTGTTGCGGCATTGTCTATGTTC|ACCCTTTGTCGCATGCCCGAATTTTAAGCA
CTTGCGCAAATAACGGGGCCTACGGCCCCG|TAAAGGACCTTGCGCAAATAACGGGGCCTA
CCGGGGTTAAAGCAGACTGGGCGGTGAACG|AGGTGTGAGGACCTTGCGCAAATAACGGGG
GAGGACCTTGCGCAAATAACGGGGCCTACG|ATTCATTAAAGGACCTTGCGCAAATAACGG
GGTGTCCTATGAAATAAGGAAGGTATGGTT|CTATGCAAGCCGGGGTTAAAGCAGACTGGG
TTCTAATATGTTGTGTTCCCGACAGTTGGC|ACCTTGCGCAAATAACGGGGCCTACGGGCC
CCACTGGTGCTCCGCGCCCGACCCCGGCCT|TCTAATACTGGTCCCACTGTGTAAATACCC
GGGCCTACGGGCCTACGGGTGGGTACTGTT|ACGGGTCTGTCCCCCCAGTTTGGAATGGAA
ATCTCGAGAGCCTATACGCATCAAGGACCT|TCAGAGGACCTTGCGCAAATAACGGGGCCT
CGGTCCACCTCCATTTTCCACTGATAGTCA|CGACCACCACGTTTGAAACGGCCTACTTTC
GCCTACGGCACCCGTCTAACTGAGGACCTT|CGAATGGGCTCGCGAATCTGTATTCATTAA
TTACGGCTGAGCCCTGTCCTCAACTGCAAA|AACACTATGACCAGTTACGTCCAACGAGGA
AGCTGTATCGAGGACCTTGCGCAAATAACG|CTACGGCCCCGAGGACCTTGCGCAAATAAC
GACTCGGAATGTGATACAAATAGCTCTGTA|AGCGATTCTGTACTCGTGCACGACCCGACC
AGGACCTTGCGCAAATAACGGGGCCTACGG|CTACCTGTTAGCTGTGAACCAGGTGGATAG
ACGGGGCCTACGGCACCCGTCTAACTGAGG|GTGCGCGAATGGGCTCGCGAATCTGTATTC
ATACAAATAGCTCTGTAAAGGTCATTGTGT|TCGTGCACGACCCGACCGCCTTAGACTCCT
ATAACGGGGCCTACGGAGCTGTATCGAGGA|GCGCAAATAACGGGGCCTACGGCCCCGAGG
AACGGGGCCTACGGGTCTGTCCCCCCAGTT|GAAATAAGGAAGGTATGGTTAAGAGTCACA
TTGTCGCATGCCCGAATTTTAAGCAGCGAC|GCAAGGGCCTGTGGGTGCGTAATATTCGCA
CAAATAACGGGGCCTACGGCACCCGTCTAA|GTCGGGGTGCGCGAATGGGCTCGCGAATCT
AATAACGGGAGGACCTTGCGCAAATAACGG|CATAGGACCTTGCGCAAATAACGGGGCCTA
GAATTTTAAGCAGCGACCACCACGTTTGAA|GGTGCGTAATATTCGCAAAGCATACTCGGT
TCGATATGTAGCCGGAGGACCTTGCGCAAA|GTTGCGGCATTGTCTATGTTCTCGGTCCAC
GCTCCGCGCGTCCACGTATCACCCCCAGTA|ACGGGGCCTACGGTGAGCCGGCGTATGCAT
GTCAGCGATTCTGTACTCGTGCACGACCCG|TTTCAGCCCTCCATCGAACGACACGTTTGC
ACGGCCCCGAGGACCTTGCGCAAATAACGG|CGGGGCCTACGGCTCGATATGTAGCCGGAG
CCGGCCTTCTCTGTTGCGGCATTGTCTATG|AATACCCTTTGTCGCATGCCCGAATTTTAA
TCGGGGTGCGCGAATGGGCTCGCGAATCTG|ATGTGATACAAATAGCTCTGTAAAGGTCAT
AATAACGGGGCCTACGGCCCCGAGGACCTT|CTTGCGCAAATAACGGGGCCTACGGCTCGA
GTCAGACATTGCACTGTTTTATTATTTTTC|AATTCTAATATGTTGTGTTCCCGACAGTTG
AACGGGGCCAGGACCTTGCGCAAATAACGG|CTTGCGCAAATAACGGGGCCTACGGGTTCA
AAATTAGTAAGCCAATGCTCCGCGCGTCCA|GGACCTTGCGCAAATAACGGGGCCTACGGT
TGGAACCAAATCCACGAAGGACCTTGCGCA|TAAAAATCTCGAGAGCCTATACGCATCAAG
GGAAAGGCACGGTGTCCTATGAAATAAGGA|AGCTTGGATCCTATGCAAGCCGGGGTTAAA
GGTCTGTCCCCCCAGTTTGGAATGGAACCA|TATGGTTAAGAGTCACATCACCTAAAAATC
CCTACGGAGCTGTATCGAGGACCTTGCGCA|ACGGGGCCTACGGCCCCGAGGACCTTGCGC
TGAGGACCTTGCGCAAATAACGGGGCCTAC|TATTCATTAAAGGACCTTGCGCAAATAACG
GAGGGCTGATTTCATAATTCTAATATGTTG|GCGCAAATAACGGGAGGACCTTGCGCAAAT
AAGGACCTTGCGCAAATAACGGGGCCAGGA|CTATACGCATCAAGGACCTTGCGCAAATAA
GACTGGGCGGTGAACGCGCGCCAAACTTCA|TGCGCAAATAACGGGGCCTACGGCACCCGT
ACTGATAGTCAGCGATTCTGTACTCGTGCA|GGCCTACTTTCAGCCCTCCATCGAACGACA
ATCAAGGACCTTGCGCAAATAACGGGGCCT|TAACGGGGCCTACGGAGCTGTATCGAGGAC
GGCATGCCTACCTGTTAGCTGTGAACCAGG|ATCCACGAAGGACCTTGCGCAAATAACGGG
CGGGTGGGTACTGTTCCATGGCATGCCTAC|CAGTTTGGAATGGAACCAAATCCACGAAGG
CGGCCCCGAGGACCTTGCGCAAATAACGGA|GGGGCCTACGGCTCGATATGTAGCCGGAGG
GCGCAAATAACGGGGCCTACGGGTTCAGTA|CGGAGCTGTATCGAGGACCTTGCGCAAATA
ACCCCCAGTATGCCCCGCGAGGGCTGATTT|GCGTATGCATAGGACCTTGCGCAAATAACG
AAAGCATCTTGTATACCATAGGACCTTGCG|CGGGGCCTACGGTACGGAAAGGCACGGTGT
GTTAAGAGTCACATCACCTAAAAATCTCGA|GGGCGGTGAACGCGCGCCAAACTTCAGAGG
GTATTCTACACAAGCTTGGATCCTATGCAA|ATAACGGGGCCTACGGATGGCGTCGAGCCG
CGTTCTTACGGCTGAGCCCTGTCCTCAACT|GGCAGAACACTATGACCAGTTACGTCCAAC
ATGCCTACCTGTTAGCTGTGAACCAGGTGG|CACGAAGGACCTTGCGCAAATAACGGGGCC
TCCACCTCCATTTTCCACTGATAGTCAGCG|CCACCACGTTTGAAACGGCCTACTTTCAGC
AGGTGTGAGGACCTTGCGCAAATAACGGGG|CCTACGGGGCCTACGGTAGTCGGGGTGCGC
TTGCGCAAATAACGGGGCCTACGGAGCTGT|AGGACCTTGCGCAAATAACGGGGCCTACGG
TCGTTCTTACGGCTGAGCCCTGTCCTCAAC|TGGCAGAACACTATGACCAGTTACGTCCAA
CCATGGCATGCCTACCTGTTAGCTGTGAAC|CCAAATCCACGAAGGACCTTGCGCAAATAA
GGTGCGCGAATGGGCTCGCGAATCTGTATT|GATACAAATAGCTCTGTAAAGGTCATTGTG
CTTGCGCAAATAACGGGGCCTACGGCTCGA|CTCCGCGCCCGACCCCGGCCTTCTCTGTTG
GGCCTACGGGCCTACGGGTGGGTACTGTTC|CGGGTCTGTCCCCCCAGTTTGGAATGGAAC
TAACTGAGGACCTTGCGCAAATAACGGGGC|TCTGTATTCATTAAAGGACCTTGCGCAAAT
TCCAACGAGGACCTTGCGCAAATAACGGGG|GGCATGCCTACCTGTTAGCTGTGAACCAGG
GCGAATCTGTATTCATTAAAGGACCTTGCG|AAAGGTCATTGTGTACCACTGGTGCTCCGC
TTGCGGCATTGTCTATGTTCTCGGTCCACC|GCATGCCCGAATTTTAAGCAGCGACCACCA
TGCGCAAATAACGGGGCCTACGGTGAGCCG|TTAGCTGTGAACCAGGTGGATAGAAGATCC
GCGCAAATAACGGGGCCTACGGGGCCTACG|GCAAATAACGGGGCCTACGGTGGGGGGACT
GACCTTGCGCAAATAACGGGGCCTACGGAG|ACTGAGGACCTTGCGCAAATAACGGGGCCT
TGATAGTCAGCGATTCTGTACTCGTGCACG|CCTACTTTCAGCCCTCCATCGAACGACACG
TGTTTTATTATTTTTCGTTCTTACGGCTGA|GTGTTCCCGACAGTTGGCAGAACACTATGA
CAAATAACGGAGGACCTTGCGCAAATAACG|GTAGCCGGAGGACCTTGCGCAAATAACGGG
AAGATCCTGTTCTAAAAGCATCTTGTATAC|CCTTGCGCAAATAACGGGGCCTACGGTACG
ACGGGGCCTACGGGCCTACGGGTGGGTACT|CCTACGGGTCTGTCCCCCCAGTTTGGAATG
TGCGCAAATAACGGGGCCTACGGGGCCTAC|CGCAAATAACGGGGCCTACGGTGGGGGGAC
GACCTTGCGCAAATAACGGGAGGACCTTGC|ATCTTGTATACCATAGGACCTTGCGCAAAT
CCATAGGACCTTGCGCAAATAACGGGGCCT|GGAAAGGCACGGTGTCCTATGAAATAAGGA
CACTGGTGCTCCGCGCCCGACCCCGGCCTT|CTAATACTGGTCCCACTGTGTAAATACCCT
AAAAGCATCTTGTATACCATAGGACCTTGC|ACGGGGCCTACGGTACGGAAAGGCACGGTG
TCAAGGACCTTGCGCAAATAACGGGGCCTA|AACGGGGCCTACGGAGCTGTATCGAGGACC
GCCTACGGGTCTGTCCCCCCAGTTTGGAAT|AGGAAGGTATGGTTAAGAGTCACATCACCT
TAACGGGGCCTACGGTGGGGGGACTCGGAA|CTCCATTTTCCACTGATAGTCAGCGATTCT
TCAGCGATTCTGTACTCGTGCACGACCCGA|TTCAGCCCTCCATCGAACGACACGTTTGCG
CCTTGCGCAAATAACGGGGCCTACGGTACG|CGGGGCCTACGGGTTCAGTATTCTACACAA
AGCCGGAGGACCTTGCGCAAATAACGGGGC|TTGTCTATGTTCTCGGTCCACCTCCATTTT
GTATGCATAGGACCTTGCGCAAATAACGGG|TTCTAAAAGCATCTTGTATACCATAGGACC
AGACTCCTGTCTAATACTGGTCCCACTGTG|GATACTCGAGTTATGCGCATTTCACTGAAG
GGTACTGTTCCATGGCATGCCTACCTGTTA|GGAATGGAACCAAATCCACGAAGGACCTTG
GATATGTAGCCGGAGGACCTTGCGCAAATA|TGCGGCATTGTCTATGTTCTCGGTCCACCT
CGTCTAACTGAGGACCTTGCGCAAATAACG|CGAATCTGTATTCATTAAAGGACCTTGCGC
TTGTGTTCCCGACAGTTGGCAGAACACTAT|AATAACGGGGCCTACGGGCCTACGGGTGGG
GCAAATAACGGGGCCTACGGCTCGATATGT|CGCCCGACCCCGGCCTTCTCTGTTGCGGCA
TCTGTCCCCCCAGTTTGGAATGGAACCAAA|TGGTTAAGAGTCACATCACCTAAAAATCTC
TAACGGGGCCTACGGGTCTGTCCCCCCAGT|TGAAATAAGGAAGGTATGGTTAAGAGTCAC
GCCGAAGGTGTGAGGACCTTGCGCAAATAA|CGGGGCCTACGGGGCCTACGGTAGTCGGGG
ATGCTCCGCGCGTCCACGTATCACCCCCAG|TAACGGGGCCTACGGTGAGCCGGCGTATGC
ACTGGTGCTCCGCGCCCGACCCCGGCCTTC|TAATACTGGTCCCACTGTGTAAATACCCTT
GGTTCAGTATTCTACACAAGCTTGGATCCT|GCGCAAATAACGGGGCCTACGGATGGCGTC
CATGCCTACCTGTTAGCTGTGAACCAGGTG|CCACGAAGGACCTTGCGCAAATAACGGGGC
CTGTTGCGGCATTGTCTATGTTCTCGGTCC|GTCGCATGCCCGAATTTTAAGCAGCGACCA
TGTGATACAAATAGCTCTGTAAAGGTCATT|GTACTCGTGCACGACCCGACCGCCTTAGAC
TATGACCAGTTACGTCCAACGAGGACCTTG|GGGTACTGTTCCATGGCATGCCTACCTGTT
CAAGGACCTTGCGCAAATAACGGGGCCTAC|ACGGGGCCTACGGAGCTGTATCGAGGACCT
GGGCCTACGGGTCTGTCCCCCCAGTTTGGA|TAAGGAAGGTATGGTTAAGAGTCACATCAC
ATTGTCTATGTTCTCGGTCCACCTCCATTT|CGAATTTTAAGCAGCGACCACCACGTTTGA
GCGCAAATAACGGGGCCAGGACCTTGCGCA|TCAAGGACCTTGCGCAAATAACGGGGCCTA
CCTTGCGCAAATAACGGAGGACCTTGCGCA|TCGATATGTAGCCGGAGGACCTTGCGCAAA
TAACGCACGTCAGACATTGCACTGTTTTAT|GATTTCATAATTCTAATATGTTGTGTTCCC
GGCCTTCTCTGTTGCGGCATTGTCTATGTT|TACCCTTTGTCGCATGCCCGAATTTTAAGC
AACGGGGCCTACGGGGCCTACGGTAGTCGG|CGGGGCCTACGGTGGGGGGACTCGGAATGT
ACGCGCGCCAAACTTCAGAGGACCTTGCGC|GGGCCTACGGCACCCGTCTAACTGAGGACC
GACCTTGCGCAAATAACGGGGCCTACGGGC|GCGCAAATAACGGGGCCTACGGGTCTGTCC
AATAACGGGGCCTACGGTGGGGGGACTCGG|ACCTCCATTTTCCACTGATAGTCAGCGATT
ACGGGGCCTACGGAGCTGTATCGAGGACCT|CAAATAACGGGGCCTACGGCCCCGAGGACC
TTAAAGCAGACTGGGCGGTGAACGCGCGCC|GAGGACCTTGCGCAAATAACGGGGCCTACG
GCACGGTGTCCTATGAAATAAGGAAGGTAT|GATCCTATGCAAGCCGGGGTTAAAGCAGAC
GGGGCCTACGGGTCTGTCCCCCCAGTTTGG|ATAAGGAAGGTATGGTTAAGAGTCACATCA
TTTGGAATGGAACCAAATCCACGAAGGACC|CATCACCTAAAAATCTCGAGAGCCTATACG
GGGGTTAAAGCAGACTGGGCGGTGAACGCG|GTGTGAGGACCTTGCGCAAATAACGGGGCC
TACACAAGCTTGGATCCTATGCAAGCCGGG|GGGCCTACGGATGGCGTCGAGCCGAAGGTG
TGGGCGGTGAACGCGCGCCAAACTTCAGAG|GCAAATAACGGGGCCTACGGCACCCGTCTA
CCCCGCGAGGGCTGATTTCATAATTCTAAT|GACCTTGCGCAAATAACGGGAGGACCTTGC
GGGGCCTACGGAGCTGTATCGAGGACCTTG|AATAACGGGGCCTACGGCCCCGAGGACCTT
CCTGTCTAATACTGGTCCCACTGTGTAAAT|TCGAGTTATGCGCATTTCACTGAAGACCAT
CTCCATTTTCCACTGATAGTCAGCGATTCT|ACGTTTGAAACGGCCTACTTTCAGCCCTCC
CGAGAGCCTATACGCATCAAGGACCTTGCG|AGGACCTTGCGCAAATAACGGGGCCTACGG
TGAACGCGCGCCAAACTTCAGAGGACCTTG|ACGGGGCCTACGGCACCCGTCTAACTGAGG
TGTTCCCGACAGTTGGCAGAACACTATGAC|AACGGGGCCTACGGGCCTACGGGTGGGTAC
AGCATCTTGTATACCATAGGACCTTGCGCA|GGGCCTACGGTACGGAAAGGCACGGTGTCC
CGGGGCCTACGGTGGGGGGACTCGGAATGT|CATTTTCCACTGATAGTCAGCGATTCTGTA
CGAATTTTAAGCAGCGACCACCACGTTTGA|GGGTGCGTAATATTCGCAAAGCATACTCGG
AAATAACGGAGGACCTTGCGCAAATAACGG|TAGCCGGAGGACCTTGCGCAAATAACGGGG
AACGGGGCCTACGGTGAGCCGGCGTATGCA|AACCAGGTGGATAGAAGATCCTGTTCTAAA
TATACCATAGGACCTTGCGCAAATAACGGG|GTACGGAAAGGCACGGTGTCCTATGAAATA
CGAAGGACCTTGCGCAAATAACGGGGCCAG|GCCTATACGCATCAAGGACCTTGCGCAAAT
AACGGGGCCTACGGGTTCAGTATTCTACAC|TATCGAGGACCTTGCGCAAATAACGGGGCC
GGTGTGAGGACCTTGCGCAAATAACGGGGC|CTACGGGGCCTACGGTAGTCGGGGTGCGCG
GGGTTAAAGCAGACTGGGCGGTGAACGCGC|TGTGAGGACCTTGCGCAAATAACGGGGCCT
TTGGAATGGAACCAAATCCACGAAGGACCT|ATCACCTAAAAATCTCGAGAGCCTATACGC
CCTTGCGCAAATAACGGGAGGACCTTGCGC|CTTGTATACCATAGGACCTTGCGCAAATAA
AATAACGGGGCCTACGGTGAGCCGGCGTAT|GTGAACCAGGTGGATAGAAGATCCTGTTCT
ACCAAATCCACGAAGGACCTTGCGCAAATA|AATCTCGAGAGCCTATACGCATCAAGGACC
TGCAAATTAGTAAGCCAATGCTCCGCGCGT|CGAGGACCTTGCGCAAATAACGGGGCCTAC
TACGGTGAGCCGGCGTATGCATAGGACCTT|GATAGAAGATCCTGTTCTAAAAGCATCTTG
ATAACGGGGCCTACGGGTTCAGTATTCTAC|TGTATCGAGGACCTTGCGCAAATAACGGGG
GCGCGAATGGGCTCGCGAATCTGTATTCAT|ACAAATAGCTCTGTAAAGGTCATTGTGTAC
CACTGTGTAAATACCCTTTGTCGCATGCCC|ACTGAAGACCATAAAAGGCAAGGGCCTGTG
TACGGCTGAGCCCTGTCCTCAACTGCAAAT|ACACTATGACCAGTTACGTCCAACGAGGAC
TACTGTTCCATGGCATGCCTACCTGTTAGC|AATGGAACCAAATCCACGAAGGACCTTGCG
GAATGTGATACAAATAGCTCTGTAAAGGTC|TCTGTACTCGTGCACGACCCGACCGCCTTA
GCCTACGGGCCTACGGGTGGGTACTGTTCC|GGGTCTGTCCCCCCAGTTTGGAATGGAACC
GCGTCCACGTATCACCCCCAGTATGCCCCG|CTACGGTGAGCCGGCGTATGCATAGGACCT
ACGGCACCCGTCTAACTGAGGACCTTGCGC|TGGGCTCGCGAATCTGTATTCATTAAAGGA
GGAATGGAACCAAATCCACGAAGGACCTTG|CACCTAAAAATCTCGAGAGCCTATACGCAT
AACGGGGCCTACGGAGCTGTATCGAGGACC|GCAAATAACGGGGCCTACGGCCCCGAGGAC
TGTAGCCGGAGGACCTTGCGCAAATAACGG|GCATTGTCTATGTTCTCGGTCCACCTCCAT
TACTCGTGCACGACCCGACCGCCTTAGACT|TCGAACGACACGTTTGCGACTGCTTGATAC
GGGCCTACGGGTTCAGTATTCTACACAAGC|GAGGACCTTGCGCAAATAACGGGGCCTACG
GGTGGGGGGACTCGGAATGTGATACAAATA|TGATAGTCAGCGATTCTGTACTCGTGCACG
CGCCTTAGACTCCTGTCTAATACTGGTCCC|CTGCTTGATACTCGAGTTATGCGCATTTCA
CGCGCCCGACCCCGGCCTTCTCTGTTGCGG|CCCACTGTGTAAATACCCTTTGTCGCATGC
GGTACGGAAAGGCACGGTGTCCTATGAAAT|ACACAAGCTTGGATCCTATGCAAGCCGGGG
CCTTGCGCAAATAACGGGGCCTACGGTGGG|TCTCGGTCCACCTCCATTTTCCACTGATAG
GGGGCCTACGGCTCGATATGTAGCCGGAGG|CCGGCCTTCTCTGTTGCGGCATTGTCTATG
GTCCACGTATCACCCCCAGTATGCCCCGCG|ACGGTGAGCCGGCGTATGCATAGGACCTTG
GTCTGTCCCCCCAGTTTGGAATGGAACCAA|ATGGTTAAGAGTCACATCACCTAAAAATCT
TACGGTACGGAAAGGCACGGTGTCCTATGA|TCTACACAAGCTTGGATCCTATGCAAGCCG
CCCACTGTGTAAATACCCTTTGTCGCATGC|TCACTGAAGACCATAAAAGGCAAGGGCCTG
CAAATAACGGGGCCTACGGTGAGCCGGCGT|CTGTGAACCAGGTGGATAGAAGATCCTGTT
CAAATTAGTAAGCCAATGCTCCGCGCGTCC|AGGACCTTGCGCAAATAACGGGGCCTACGG
CCCAGTTTGGAATGGAACCAAATCCACGAA|AGTCACATCACCTAAAAATCTCGAGAGCCT
GGGCCAGGACCTTGCGCAAATAACGGGGCC|CGCAAATAACGGGGCCTACGGGTTCAGTAT
CGTATCACCCCCAGTATGCCCCGCGAGGGC|GAGCCGGCGTATGCATAGGACCTTGCGCAA
CACTATGACCAGTTACGTCCAACGAGGACC|GGTGGGTACTGTTCCATGGCATGCCTACCT
GACCTTGCGCAAATAACGGGGCCTACGGGT|GGCCTACGGAGCTGTATCGAGGACCTTGCG
TCATTGTGTACCACTGGTGCTCCGCGCCCG|TAGACTCCTGTCTAATACTGGTCCCACTGT
CCGCGCGTCCACGTATCACCCCCAGTATGC|GGGCCTACGGTGAGCCGGCGTATGCATAGG
CGGGGCCTACGGTGAGCCGGCGTATGCATA|CCAGGTGGATAGAAGATCCTGTTCTAAAAG
GGGCCTACGGAGCTGTATCGAGGACCTTGC|ATAACGGGGCCTACGGCCCCGAGGACCTTG
TACAAATAGCTCTGTAAAGGTCATTGTGTA|CGTGCACGACCCGACCGCCTTAGACTCCTG
CGTCAGACATTGCACTGTTTTATTATTTTT|TAATTCTAATATGTTGTGTTCCCGACAGTT
GTCACATCACCTAAAAATCTCGAGAGCCTA|GAACGCGCGCCAAACTTCAGAGGACCTTGC
CGGGGCCTACGGGTTCAGTATTCTACACAA|TCGAGGACCTTGCGCAAATAACGGGGCCTA
TCTCTGTTGCGGCATTGTCTATGTTCTCGG|TTTGTCGCATGCCCGAATTTTAAGCAGCGA
TACCATAGGACCTTGCGCAAATAACGGGGC|ACGGAAAGGCACGGTGTCCTATGAAATAAG
TGTTCCATGGCATGCCTACCTGTTAGCTGT|GGAACCAAATCCACGAAGGACCTTGCGCAA
GCCGGAGGACCTTGCGCAAATAACGGGGCC|TGTCTATGTTCTCGGTCCACCTCCATTTTC
GCGGCATTGTCTATGTTCTCGGTCCACCTC|ATGCCCGAATTTTAAGCAGCGACCACCACG
CCTCAACTGCAAATTAGTAAGCCAATGCTC|CGTCCAACGAGGACCTTGCGCAAATAACGG
CTTGCGCAAATAACGGGGCCTACGGTACGG|GGGGCCTACGGGTTCAGTATTCTACACAAG
TCCGCGCGTCCACGTATCACCCCCAGTATG|GGGGCCTACGGTGAGCCGGCGTATGCATAG
GCCTACGGGTGGGTACTGTTCCATGGCATG|CCCCCCAGTTTGGAATGGAACCAAATCCAC
GACCTTGCGCAAATAACGGGGCCTACGGGG|CCTTGCGCAAATAACGGGGCCTACGGTGGG
GGACCTTGCGCAAATAACGGGGCCTACGGG|GGCACGGTGTCCTATGAAATAAGGAAGGTA
TATGTAGCCGGAGGACCTTGCGCAAATAAC|CGGCATTGTCTATGTTCTCGGTCCACCTCC
CCCGCGAGGGCTGATTTCATAATTCTAATA|ACCTTGCGCAAATAACGGGAGGACCTTGCG
GACAGTTGGCAGAACACTATGACCAGTTAC|CCTACGGGCCTACGGGTGGGTACTGTTCCA
TAGGACCTTGCGCAAATAACGGGGCCTACG|AAGGCACGGTGTCCTATGAAATAAGGAAGG
GTAAAGGTCATTGTGTACCACTGGTGCTCC|ACCGCCTTAGACTCCTGTCTAATACTGGTC
TTGCGCAAATAACGGGGCCTACGGCTCGAT|TCCGCGCCCGACCCCGGCCTTCTCTGTTGC
TAACGGGGCCTACGGCACCCGTCTAACTGA|GGGTGCGCGAATGGGCTCGCGAATCTGTAT
TGCGCAAATAACGGGGCCTACGGCCCCGAG|AAGGACCTTGCGCAAATAACGGGGCCTACG
CCGGAGGACCTTGCGCAAATAACGGGGCCT|GTCTATGTTCTCGGTCCACCTCCATTTTCC
GCGCAAATAACGGGGCCTACGGATGGCGTC|TGCGCAAATAACGGAGGACCTTGCGCAAAT
CTGTACTCGTGCACGACCCGACCGCCTTAG|CCATCGAACGACACGTTTGCGACTGCTTGA
AAATCTCGAGAGCCTATACGCATCAAGGAC|CTTCAGAGGACCTTGCGCAAATAACGGGGC
CGGGGCCTACGGCCCCGAGGACCTTGCGCA|GCAAATAACGGGGCCTACGGCTCGATATGT
GCAAATAACGGGGCCTACGGCCCCGAGGAC|GACCTTGCGCAAATAACGGGGCCTACGGCT
GTTGGCAGAACACTATGACCAGTTACGTCC|CGGGCCTACGGGTGGGTACTGTTCCATGGC
ACAAATAGCTCTGTAAAGGTCATTGTGTAC|GTGCACGACCCGACCGCCTTAGACTCCTGT
CTTGCGCAAATAACGGGAGGACCTTGCGCA|TTGTATACCATAGGACCTTGCGCAAATAAC
CTCCTGTCTAATACTGGTCCCACTGTGTAA|ACTCGAGTTATGCGCATTTCACTGAAGACC
ACGAAGGACCTTGCGCAAATAACGGGGCCA|AGCCTATACGCATCAAGGACCTTGCGCAAA
GCAAATAACGGGGCCTACGGGTCTGTCCCC|TCCTATGAAATAAGGAAGGTATGGTTAAGA
GGTATGGTTAAGAGTCACATCACCTAAAAA|CAGACTGGGCGGTGAACGCGCGCCAAACTT
TGGCATGCCTACCTGTTAGCTGTGAACCAG|AATCCACGAAGGACCTTGCGCAAATAACGG
CGAGCCGAAGGTGTGAGGACCTTGCGCAAA|TAACGGGGCCTACGGGGCCTACGGTAGTCG
GCCCCGAGGACCTTGCGCAAATAACGGAGG|GGCCTACGGCTCGATATGTAGCCGGAGGAC
TGTTAGCTGTGAACCAGGTGGATAGAAGAT|CCTTGCGCAAATAACGGGGCCAGGACCTTG
CGACCCCGGCCTTCTCTGTTGCGGCATTGT|GTGTAAATACCCTTTGTCGCATGCCCGAAT
TTCTTACGGCTGAGCCCTGTCCTCAACTGC|CAGAACACTATGACCAGTTACGTCCAACGA
AAGGTATGGTTAAGAGTCACATCACCTAAA|AGCAGACTGGGCGGTGAACGCGCGCCAAAC
CGCAAATAACGGGGCCTACGGGCCTACGGG|TAACGGGGCCTACGGGTCTGTCCCCCCAGT
TTGCGCAAATAACGGGGCCAGGACCTTGCG|CATCAAGGACCTTGCGCAAATAACGGGGCC
CTCGGAATGTGATACAAATAGCTCTGTAAA|CGATTCTGTACTCGTGCACGACCCGACCGC
CTGCAAATTAGTAAGCCAATGCTCCGCGCG|ACGAGGACCTTGCGCAAATAACGGGGCCTA
GATGGCGTCGAGCCGAAGGTGTGAGGACCT|TGCGCAAATAACGGGGCCTACGGGGCCTAC
AGGTATGGTTAAGAGTCACATCACCTAAAA|GCAGACTGGGCGGTGAACGCGCGCCAAACT
CTGTGTAAATACCCTTTGTCGCATGCCCGA|TGAAGACCATAAAAGGCAAGGGCCTGTGGG
CTATGTTCTCGGTCCACCTCCATTTTCCAC|TTTAAGCAGCGACCACCACGTTTGAAACGG
ATACTGGTCCCACTGTGTAAATACCCTTTG|TGCGCATTTCACTGAAGACCATAAAAGGCA
CAGCGATTCTGTACTCGTGCACGACCCGAC|TCAGCCCTCCATCGAACGACACGTTTGCGA
GTATGGTTAAGAGTCACATCACCTAAAAAT|AGACTGGGCGGTGAACGCGCGCCAAACTTC
TGTATCGAGGACCTTGCGCAAATAACGGGG|CGGCCCCGAGGACCTTGCGCAAATAACGGA
TTCTACACAAGCTTGGATCCTATGCAAGCC|ACGGGGCCTACGGATGGCGTCGAGCCGAAG
CAGGTGGATAGAAGATCCTGTTCTAAAAGC|CGGGGCCAGGACCTTGCGCAAATAACGGGG
ACAGTTGGCAGAACACTATGACCAGTTACG|CTACGGGCCTACGGGTGGGTACTGTTCCAT
ATGCCCGAATTTTAAGCAGCGACCACCACG|CCTGTGGGTGCGTAATATTCGCAAAGCATA
CGAGGACCTTGCGCAAATAACGGAGGACCT|TACGGCTCGATATGTAGCCGGAGGACCTTG
GCGCAAATAACGGGGCCTACGGAGCTGTAT|GACCTTGCGCAAATAACGGGGCCTACGGCC
GACCCGACCGCCTTAGACTCCTGTCTAATA|GTTTGCGACTGCTTGATACTCGAGTTATGC
CTGTCCCCCCAGTTTGGAATGGAACCAAAT|GGTTAAGAGTCACATCACCTAAAAATCTCG
GCCCGAATTTTAAGCAGCGACCACCACGTT|TGTGGGTGCGTAATATTCGCAAAGCATACT
GCCAAACTTCAGAGGACCTTGCGCAAATAA|ACGGCACCCGTCTAACTGAGGACCTTGCGC
TGCACGACCCGACCGCCTTAGACTCCTGTC|GACACGTTTGCGACTGCTTGATACTCGAGT
ACCCGACCGCCTTAGACTCCTGTCTAATAC|TTTGCGACTGCTTGATACTCGAGTTATGCG
CTACGGGTCTGTCCCCCCAGTTTGGAATGG|GAAGGTATGGTTAAGAGTCACATCACCTAA
GGGCCTACGGATGGCGTCGAGCCGAAGGTG|GGAGGACCTTGCGCAAATAACGGGGCCTAC
AACCAGGTGGATAGAAGATCCTGTTCTAAA|TAACGGGGCCAGGACCTTGCGCAAATAACG
TCACCTAAAAATCTCGAGAGCCTATACGCA|GCGCCAAACTTCAGAGGACCTTGCGCAAAT
ATGGTTAAGAGTCACATCACCTAAAAATCT|ACTGGGCGGTGAACGCGCGCCAAACTTCAG
CCTTGCGCAAATAACGGGGCCTACGGGTCT|ACGGTGTCCTATGAAATAAGGAAGGTATGG
CCGAATTTTAAGCAGCGACCACCACGTTTG|TGGGTGCGTAATATTCGCAAAGCATACTCG
AGAGGACCTTGCGCAAATAACGGGGCCTAC|TCTAACTGAGGACCTTGCGCAAATAACGGG
GCAAATAACGGGGCCTACGGGTTCAGTATT|GAGCTGTATCGAGGACCTTGCGCAAATAAC
ACGCACGTCAGACATTGCACTGTTTTATTA|TTTCATAATTCTAATATGTTGTGTTCCCGA
TAGACTCCTGTCTAATACTGGTCCCACTGT|TGATACTCGAGTTATGCGCATTTCACTGAA
GGGCCTACGGGTGGGTACTGTTCCATGGCA|GTCCCCCCAGTTTGGAATGGAACCAAATCC
ACTCGGAATGTGATACAAATAGCTCTGTAA|GCGATTCTGTACTCGTGCACGACCCGACCG
GGGGCCTACGGATGGCGTCGAGCCGAAGGT|CGGAGGACCTTGCGCAAATAACGGGGCCTA
GGCACCCGTCTAACTGAGGACCTTGCGCAA|GGCTCGCGAATCTGTATTCATTAAAGGACC
TTAGTAAGCCAATGCTCCGCGCGTCCACGT|CCTTGCGCAAATAACGGGGCCTACGGTGAG
ATAACGGGGCCTACGGGCCTACGGGTGGGT|GGGCCTACGGGTCTGTCCCCCCAGTTTGGA
CCTTGCGCAAATAACGGGGCCTACGGCCCC|TTAAAGGACCTTGCGCAAATAACGGGGCCT
CGGAATGTGATACAAATAGCTCTGTAAAGG|ATTCTGTACTCGTGCACGACCCGACCGCCT
CGGCACCCGTCTAACTGAGGACCTTGCGCA|GGGCTCGCGAATCTGTATTCATTAAAGGAC
GAGGACCTTGCGCAAATAACGGGGCCTACG|TATGTTCTCGGTCCACCTCCATTTTCCACT
ATAACGGGGCCTACGGATGGCGTCGAGCCG|AATAACGGAGGACCTTGCGCAAATAACGGG
CTACGGTGAGCCGGCGTATGCATAGGACCT|GGATAGAAGATCCTGTTCTAAAAGCATCTT
GGAGGACCTTGCGCAAATAACGGGGCCTAC|AGGACCTTGCGCAAATAACGGGGCCTACGG
CTCGATATGTAGCCGGAGGACCTTGCGCAA|TGTTGCGGCATTGTCTATGTTCTCGGTCCA
CTTGCGCAAATAACGGGGCCTACGGAGCTG|GAGGACCTTGCGCAAATAACGGGGCCTACG
CCTACGGTAGTCGGGGTGCGCGAATGGGCT|GGGACTCGGAATGTGATACAAATAGCTCTG
ATTAAAGGACCTTGCGCAAATAACGGGGCC|ACCACTGGTGCTCCGCGCCCGACCCCGGCC
CGAATCTGTATTCATTAAAGGACCTTGCGC|AAGGTCATTGTGTACCACTGGTGCTCCGCG
GGGGGGACTCGGAATGTGATACAAATAGCT|TAGTCAGCGATTCTGTACTCGTGCACGACC
GGAGCTGTATCGAGGACCTTGCGCAAATAA|GCCTACGGCCCCGAGGACCTTGCGCAAATA
TACCACTGGTGCTCCGCGCCCGACCCCGGC|TGTCTAATACTGGTCCCACTGTGTAAATAC
TGCGCAAATAACGGGGCCTACGGGCCTACG|AATAACGGGGCCTACGGGTCTGTCCCCCCA
TGTGTACCACTGGTGCTCCGCGCCCGACCC|CTCCTGTCTAATACTGGTCCCACTGTGTAA
GGTCCACCTCCATTTTCCACTGATAGTCAG|GACCACCACGTTTGAAACGGCCTACTTTCA
CATTGTGTACCACTGGTGCTCCGCGCCCGA|AGACTCCTGTCTAATACTGGTCCCACTGTG
GACCCCGGCCTTCTCTGTTGCGGCATTGTC|TGTAAATACCCTTTGTCGCATGCCCGAATT
GGCGTATGCATAGGACCTTGCGCAAATAAC|CTGTTCTAAAAGCATCTTGTATACCATAGG
ACCTTGCGCAAATAACGGGGCCAGGACCTT|ACGCATCAAGGACCTTGCGCAAATAACGGG
ACTGTTCCATGGCATGCCTACCTGTTAGCT|ATGGAACCAAATCCACGAAGGACCTTGCGC
TGGCAGAACACTATGACCAGTTACGTCCAA|GGCCTACGGGTGGGTACTGTTCCATGGCAT
TGAAATAAGGAAGGTATGGTTAAGAGTCAC|CCGGGGTTAAAGCAGACTGGGCGGTGAACG
GAGGACCTTGCGCAAATAACGGGGCCTACG|CTAACTGAGGACCTTGCGCAAATAACGGGG
TGCCCGAATTTTAAGCAGCGACCACCACGT|CTGTGGGTGCGTAATATTCGCAAAGCATAC
TAACGGGGCCTACGGTGAGCCGGCGTATGC|GAACCAGGTGGATAGAAGATCCTGTTCTAA
TGCACTGTTTTATTATTTTTCGTTCTTACG|ATGTTGTGTTCCCGACAGTTGGCAGAACAC
TACTGGTCCCACTGTGTAAATACCCTTTGT|GCGCATTTCACTGAAGACCATAAAAGGCAA
CACTGTTTTATTATTTTTCGTTCTTACGGC|GTTGTGTTCCCGACAGTTGGCAGAACACTA
ATCCTATGCAAGCCGGGGTTAAAGCAGACT|GCGTCGAGCCGAAGGTGTGAGGACCTTGCG
TCTGTATTCATTAAAGGACCTTGCGCAAAT|TCATTGTGTACCACTGGTGCTCCGCGCCCG
CCTACGGCCCCGAGGACCTTGCGCAAATAA|TAACGGGGCCTACGGCTCGATATGTAGCCG
CACGGTGTCCTATGAAATAAGGAAGGTATG|ATCCTATGCAAGCCGGGGTTAAAGCAGACT
AAATAACGGGGCCTACGGGTCTGTCCCCCC|CTATGAAATAAGGAAGGTATGGTTAAGAGT
GGGGCCTACGGGGCCTACGGTAGTCGGGGT|GGCCTACGGTGGGGGGACTCGGAATGTGAT
ATAGTCAGCGATTCTGTACTCGTGCACGAC|TACTTTCAGCCCTCCATCGAACGACACGTT
TAATACTGGTCCCACTGTGTAAATACCCTT|TATGCGCATTTCACTGAAGACCATAAAAGG
ACGGAGGACCTTGCGCAAATAACGGGGCCT|GGAGGACCTTGCGCAAATAACGGGGCCTAC
AATAACGGGGCCTACGGAGCTGTATCGAGG|TGCGCAAATAACGGGGCCTACGGCCCCGAG
GTATACCATAGGACCTTGCGCAAATAACGG|GGTACGGAAAGGCACGGTGTCCTATGAAAT
ACTCCTGTCTAATACTGGTCCCACTGTGTA|TACTCGAGTTATGCGCATTTCACTGAAGAC
ACGTCAGACATTGCACTGTTTTATTATTTT|ATAATTCTAATATGTTGTGTTCCCGACAGT
GTTCTCGGTCCACCTCCATTTTCCACTGAT|AGCAGCGACCACCACGTTTGAAACGGCCTA
ATATGTAGCCGGAGGACCTTGCGCAAATAA|GCGGCATTGTCTATGTTCTCGGTCCACCTC
GCGCAAATAACGGGGCCTACGGTGAGCCGG|TAGCTGTGAACCAGGTGGATAGAAGATCCT
TCCTGTCTAATACTGGTCCCACTGTGTAAA|CTCGAGTTATGCGCATTTCACTGAAGACCA
CTTGCGCAAATAACGGGGCCTACGGGTCTG|CGGTGTCCTATGAAATAAGGAAGGTATGGT
AAATACCCTTTGTCGCATGCCCGAATTTTA|CCATAAAAGGCAAGGGCCTGTGGGTGCGTA
GGCCTACGGTAGTCGGGGTGCGCGAATGGG|GGGGGACTCGGAATGTGATACAAATAGCTC
CTCTGTAAAGGTCATTGTGTACCACTGGTG|CCCGACCGCCTTAGACTCCTGTCTAATACT
GGATCCTATGCAAGCCGGGGTTAAAGCAGA|TGGCGTCGAGCCGAAGGTGTGAGGACCTTG
GCTGAGCCCTGTCCTCAACTGCAAATTAGT|TATGACCAGTTACGTCCAACGAGGACCTTG
AGCTTGGATCCTATGCAAGCCGGGGTTAAA|ACGGATGGCGTCGAGCCGAAGGTGTGAGGA
TGCGCAAATAACGGGAGGACCTTGCGCAAA|GTATACCATAGGACCTTGCGCAAATAACGG
CTCGCGAATCTGTATTCATTAAAGGACCTT|TGTAAAGGTCATTGTGTACCACTGGTGCTC
GTGCACGACCCGACCGCCTTAGACTCCTGT|CGACACGTTTGCGACTGCTTGATACTCGAG
CTAATATGTTGTGTTCCCGACAGTTGGCAG|CTTGCGCAAATAACGGGGCCTACGGGCCTA
CATTTTCCACTGATAGTCAGCGATTCTGTA|TTTGAAACGGCCTACTTTCAGCCCTCCATC
ATAACGGGGCCTACGGTACGGAAAGGCACG|GGGTTCAGTATTCTACACAAGCTTGGATCC
ACCTTGCGCAAATAACGGGGCCTACGGGCC|CGCAAATAACGGGGCCTACGGGTCTGTCCC
GCACGTCAGACATTGCACTGTTTTATTATT|TCATAATTCTAATATGTTGTGTTCCCGACA
CAGAACACTATGACCAGTTACGTCCAACGA|CTACGGGTGGGTACTGTTCCATGGCATGCC
AATGTGATACAAATAGCTCTGTAAAGGTCA|CTGTACTCGTGCACGACCCGACCGCCTTAG
TGCGCAAATAACGGGGCCTACGGGTCTGTC|GTGTCCTATGAAATAAGGAAGGTATGGTTA
GCCTACGGATGGCGTCGAGCCGAAGGTGTG|AGGACCTTGCGCAAATAACGGGGCCTACGG
CTACGGCCCCGAGGACCTTGCGCAAATAAC|AACGGGGCCTACGGCTCGATATGTAGCCGG
ACGGGTGGGTACTGTTCCATGGCATGCCTA|CCAGTTTGGAATGGAACCAAATCCACGAAG
ACGCATCAAGGACCTTGCGCAAATAACGGG|CAAATAACGGGGCCTACGGAGCTGTATCGA
AAGGTGTGAGGACCTTGCGCAAATAACGGG|GCCTACGGGGCCTACGGTAGTCGGGGTGCG
TTCCATGGCATGCCTACCTGTTAGCTGTGA|AACCAAATCCACGAAGGACCTTGCGCAAAT
TGGTGCTCCGCGCCCGACCCCGGCCTTCTC|ATACTGGTCCCACTGTGTAAATACCCTTTG
CTGTATTCATTAAAGGACCTTGCGCAAATA|CATTGTGTACCACTGGTGCTCCGCGCCCGA
TCGTGCACGACCCGACCGCCTTAGACTCCT|AACGACACGTTTGCGACTGCTTGATACTCG
TCCACTGATAGTCAGCGATTCTGTACTCGT|AACGGCCTACTTTCAGCCCTCCATCGAACG
TTGCGCAAATAACGGGGCCTACGGGTTCAG|TACGGAGCTGTATCGAGGACCTTGCGCAAA
TCCATGGCATGCCTACCTGTTAGCTGTGAA|ACCAAATCCACGAAGGACCTTGCGCAAATA
CAAATAACGGGGCCTACGGGGCCTACGGTA|AATAACGGGGCCTACGGTGGGGGGACTCGG
GACCTTGCGCAAATAACGGAGGACCTTGCG|GCTCGATATGTAGCCGGAGGACCTTGCGCA
AACTGCAAATTAGTAAGCCAATGCTCCGCG|CAACGAGGACCTTGCGCAAATAACGGGGCC
CCCCCAGTTTGGAATGGAACCAAATCCACG|AGAGTCACATCACCTAAAAATCTCGAGAGC
AGACATTGCACTGTTTTATTATTTTTCGTT|TCTAATATGTTGTGTTCCCGACAGTTGGCA
AAATAACGGGGCCAGGACCTTGCGCAAATA|GGACCTTGCGCAAATAACGGGGCCTACGGG
GGTGGGTACTGTTCCATGGCATGCCTACCT|GTTTGGAATGGAACCAAATCCACGAAGGAC
CTGGTCCCACTGTGTAAATACCCTTTGTCG|GCATTTCACTGAAGACCATAAAAGGCAAGG
CACCTCCATTTTCCACTGATAGTCAGCGAT|ACCACGTTTGAAACGGCCTACTTTCAGCCC
AAAAATCTCGAGAGCCTATACGCATCAAGG|AACTTCAGAGGACCTTGCGCAAATAACGGG
ACGGGGCCTACGGCTCGATATGTAGCCGGA|CCCCGGCCTTCTCTGTTGCGGCATTGTCTA
GAATGGAACCAAATCCACGAAGGACCTTGC|ACCTAAAAATCTCGAGAGCCTATACGCATC
TACGGATGGCGTCGAGCCGAAGGTGTGAGG|ACCTTGCGCAAATAACGGGGCCTACGGGGC
GACCTTGCGCAAATAACGGGGCCTACGGCC|CATTAAAGGACCTTGCGCAAATAACGGGGC
TAAGGAAGGTATGGTTAAGAGTCACATCAC|GTTAAAGCAGACTGGGCGGTGAACGCGCGC
TGTAAAGGTCATTGTGTACCACTGGTGCTC|GACCGCCTTAGACTCCTGTCTAATACTGGT
TCCACGTATCACCCCCAGTATGCCCCGCGA|CGGTGAGCCGGCGTATGCATAGGACCTTGC
CCAGGACCTTGCGCAAATAACGGGGCCTAC|AAATAACGGGGCCTACGGGTTCAGTATTCT
TTGCGCAAATAACGGGGCCTACGGGTCTGT|GGTGTCCTATGAAATAAGGAAGGTATGGTT
AGGACCTTGCGCAAATAACGGGGCCTACGG|GGGGCCTACGGAGCTGTATCGAGGACCTTG
TCGAGCCGAAGGTGTGAGGACCTTGCGCAA|ATAACGGGGCCTACGGGGCCTACGGTAGTC
AAAATCTCGAGAGCCTATACGCATCAAGGA|ACTTCAGAGGACCTTGCGCAAATAACGGGG
TAAAGGACCTTGCGCAAATAACGGGGCCTA|CACTGGTGCTCCGCGCCCGACCCCGGCCTT
GGCATTGTCTATGTTCTCGGTCCACCTCCA|GCCCGAATTTTAAGCAGCGACCACCACGTT
ACCAGTTACGTCCAACGAGGACCTTGCGCA|ACTGTTCCATGGCATGCCTACCTGTTAGCT
CCGCGCCCGACCCCGGCCTTCTCTGTTGCG|TCCCACTGTGTAAATACCCTTTGTCGCATG
AGTATTCTACACAAGCTTGGATCCTATGCA|AATAACGGGGCCTACGGATGGCGTCGAGCC
